Player,Span,Matches,Innings,Not Out,Runs,HS,Average,100,50,0,Column 12
MV Boucher (ICC/SA),1997-2012,147,281,555,532,23,532,0,6 (6ct 0st),1.975,
AC Gilchrist (AUS),1999-2008,96,191,416,379,37,379,0,5 (5ct 0st),2.178,
IA Healy (AUS),1988-1999,119,224,395,366,29,366,0,6 (6ct 0st),1.763,
RW Marsh (AUS),1970-1984,96,182,355,343,12,343,0,6 (6ct 0st),1.950,
MS Dhoni (IND),2005-2014,90,166,294,256,38,256,0,6 (6ct 0st),1.771,
AJ Stewart (ENG),1990-2003,133,231,277,263,14,227,36,6 (6ct 0st),1.199,
BJ Watling (NZ),2009-2021,75,143,275,267,8,257,10,6 (6ct 0st),1.923,
PJL Dujon (WI),1981-1991,81,154,272,267,5,265,2,5 (5ct 0st),1.766,
BJ Haddin (AUS),2008-2015,66,128,270,262,8,262,0,6 (6ct 0st),2.109,
APE Knott (ENG),1967-1981,95,174,269,250,19,250,0,5 (4ct 1st),1.545,
MJ Prior (ENG),2007-2014,79,146,256,243,13,243,0,6 (6ct 0st),1.753,
JM Bairstow (ENG),2012-2023,95,179,253,239,14,209,30,6 (6ct 0st),1.413,
Q de Kock (SA),2014-2021,54,101,232,221,11,221,0,6 (6ct 0st),2.297,
Wasim Bari (PAK),1967-1984,81,146,228,201,27,201,0,7 (7ct 0st),1.561,
AB de Villiers (SA),2004-2018,114,217,227,222,5,101,121,6 (6ct 0st),1.046,
TG Evans (ENG),1946-1959,91,175,219,173,46,173,0,4 (4ct 0st),1.251,
RD Jacobs (WI),1998-2004,65,122,219,207,12,207,0,7 (7ct 0st),1.795,
D Ramdin (WI),2005-2016,74,131,217,205,12,205,0,5 (5ct 0st),1.656,
R Dravid (ICC/IND),1996-2012,164,301,210,210,0,0,210,3 (3ct 0st),0.697,
BB McCullum (NZ),2004-2016,101,186,209,198,11,168,30,5 (5ct 0st),1.123,
Kamran Akmal (PAK),2002-2010,53,99,206,184,22,184,0,5 (5ct 0st),2.080,
DPMD Jayawardene (SL),1997-2014,149,270,205,205,0,0,205,4 (4ct 0st),0.759,
AC Parore (NZ),1990-2002,78,138,204,197,7,194,3,5 (5ct 0st),1.478,
KC Sangakkara (SL),2000-2015,134,248,202,182,20,131,51,5 (5ct 0st),0.814,
JH Kallis (ICC/SA),1995-2013,166,315,200,200,0,0,200,4 (4ct 0st),0.634,
SMH Kirmani (IND),1976-1986,88,151,198,160,38,160,0,6 (5ct 1st),1.311,
RT Ponting (AUS),1995-2012,168,328,196,196,0,0,196,3 (3ct 0st),0.597,
DL Murray (WI),1963-1980,62,119,189,181,8,181,0,5 (5ct 0st),1.588,
ATW Grout (AUS),1957-1966,51,98,187,163,24,163,0,6 (6ct 0st),1.908,
JE Root (ENG),2012-2023,135,256,183,183,0,0,183,4 (4ct 0st),0.714,
ME Waugh (AUS),1991-2002,128,245,181,181,0,0,181,4 (4ct 0st),0.738,
Sarfaraz Ahmed (PAK),2010-2023,53,102,179,157,22,157,0,5 (5ct 0st),1.754,
IDS Smith (NZ),1980-1992,63,109,176,168,8,168,0,7 (7ct 0st),1.614,
AN Cook (ENG),2006-2018,161,300,175,175,0,0,175,3 (3ct 0st),0.583,
RW Taylor (ENG),1971-1984,57,106,174,167,7,167,0,7 (7ct 0st),1.641,
SP Fleming (NZ),1994-2008,111,199,171,171,0,0,171,5 (5ct 0st),0.859,
GC Smith (ICC/SA),2002-2014,117,225,169,169,0,0,169,5 (5ct 0st),0.751,
SPD Smith (AUS),2010-2023,102,193,168,168,0,0,168,5 (5ct 0st),0.870,
RC Russell (ENG),1988-1998,54,96,165,153,12,153,0,6 (6ct 0st),1.718,
BC Lara (ICC/WI),1990-2006,131,241,164,164,0,0,164,4 (4ct 0st),0.680,
LRPL Taylor (NZ),2007-2022,112,212,163,163,0,0,163,3 (3ct 0st),0.768,
N Dickwella (SL),2014-2023,54,98,161,134,27,133,1,5 (5ct 0st),1.642,
A Flower (ZIM),1992-2002,63,110,160,151,9,142,9,5 (5ct 0st),1.454,
TD Paine (AUS),2010-2021,35,68,157,150,7,150,0,5 (5ct 0st),2.308,
MA Taylor (AUS),1989-1999,104,197,157,157,0,0,157,4 (4ct 0st),0.796,
AR Border (AUS),1978-1994,156,277,156,156,0,0,156,4 (4ct 0st),0.563,
HAPW Jayawardene (SL),2000-2015,58,102,156,124,32,124,0,5 (5ct 0st),1.529,
JC Buttler (ENG),2014-2022,57,108,154,153,1,130,23,5 (5ct 0st),1.425,
DJ Richardson (SA),1992-1998,42,77,152,150,2,150,0,5 (5ct 0st),1.974,
Moin Khan (PAK),1990-2004,69,124,148,128,20,127,1,5 (4ct 1st),1.193,
JHB Waite (SA),1951-1965,50,94,141,124,17,124,0,4 (4ct 0st),1.500,
Younis Khan (PAK),2000-2017,118,221,139,139,0,0,139,4 (4ct 0st),0.628,
VVS Laxman (IND),1996-2012,134,248,135,135,0,0,135,4 (4ct 0st),0.544,
MJ Clarke (AUS),2004-2015,115,223,134,134,0,0,134,3 (3ct 0st),0.600,
GO Jones (ENG),2004-2006,34,66,133,128,5,128,0,6 (6ct 0st),2.015,
RR Pant (IND),2018-2022,33,65,133,119,14,119,0,6 (6ct 0st),2.046,
KS More (IND),1986-1993,49,90,130,110,20,110,0,5 (0ct 5st),1.444,
WAS Oldfield (AUS),1920-1937,54,101,130,78,52,78,0,5 (1ct 4st),1.287,
Rashid Latif (PAK),1992-2003,37,69,130,119,11,119,0,6 (6ct 0st),1.884,
ML Hayden (AUS),1994-2009,103,205,128,128,0,0,128,4 (4ct 0st),0.624,
Mushfiqur Rahim (BAN),2005-2023,86,150,125,110,15,98,12,5 (5ct 0st),0.833,
SK Warne (AUS),1992-2007,145,281,125,125,0,0,125,3 (3ct 0st),0.444,
HP Tillakaratne (SL),1989-2004,83,141,124,122,2,34,88,5 (5ct 0st),0.879,
GS Chappell (AUS),1970-1984,87,165,122,122,0,0,122,4 (4ct 0st),0.739,
IVA Richards (WI),1974-1991,121,232,122,122,0,0,122,4 (4ct 0st),0.525,
AJ Strauss (ENG),2004-2012,100,189,121,121,0,0,121,3 (3ct 0st),0.640,
IT Botham (ENG),1977-1992,102,179,120,120,0,0,120,3 (3ct 0st),0.670,
MC Cowdrey (ENG),1954-1975,114,214,120,120,0,0,120,3 (3ct 0st),0.560,
RS Kaluwitharana (SL),1992-2004,49,87,119,93,26,93,0,5 (5ct 0st),1.367,
CL Hooper (WI),1987-2002,102,189,115,115,0,0,115,4 (4ct 0st),0.608,
SR Tendulkar (IND),1989-2013,200,366,115,115,0,0,115,3 (3ct 0st),0.314,
JM Parks (ENG),1954-1968,46,86,114,103,11,101,2,5 (5ct 0st),1.325,
SR Waugh (AUS),1985-2004,168,318,112,112,0,0,112,3 (3ct 0st),0.352,
WR Hammond (ENG),1927-1947,85,154,110,110,0,0,110,3 (3ct 0st),0.714,
V Kohli (IND),2011-2023,111,213,110,110,0,0,110,3 (3ct 0st),0.516,
RB Simpson (AUS),1957-1978,62,117,110,110,0,0,110,4 (4ct 0st),0.940,
GS Sobers (WI),1954-1974,93,172,109,109,0,0,109,4 (4ct 0st),0.633,
HM Amla (SA),2004-2019,124,234,108,108,0,0,108,3 (3ct 0st),0.461,
SM Gavaskar (IND),1971-1987,125,216,108,108,0,0,108,3 (3ct 0st),0.500,
NR Mongia (IND),1994-2001,44,77,107,99,8,99,0,5 (5ct 0st),1.389,
JM Anderson (ENG),2003-2023,183,346,105,105,0,0,105,3 (3ct 0st),0.303,
M Azharuddin (IND),1984-2000,99,177,105,105,0,0,105,5 (5ct 0st),0.593,
IM Chappell (AUS),1964-1980,75,144,105,105,0,0,105,4 (4ct 0st),0.729,
GP Thorpe (ENG),1993-2005,100,179,105,105,0,0,105,4 (4ct 0st),0.586,
WP Saha (IND),2010-2021,40,77,104,92,12,92,0,6 (5ct 1st),1.350,
Saleem Yousuf (PAK),1982-1990,32,58,104,91,13,91,0,5 (5ct 0st),1.793,
GA Gooch (ENG),1975-1995,118,211,103,103,0,0,103,3 (3ct 0st),0.488,
JR Murray (WI),1993-2002,33,61,102,99,3,98,1,5 (5ct 0st),1.672,
AM Rahane (IND),2013-2023,85,163,102,102,0,0,102,5 (5ct 0st),0.625,
BA Stokes (ENG),2013-2023,97,185,102,102,0,0,102,5 (5ct 0st),0.551,
IR Bell (ENG),2004-2015,118,223,100,100,0,0,100,3 (3ct 0st),0.448,
DC Boon (AUS),1984-1996,107,195,99,99,0,0,99,4 (4ct 0st),0.507,
J Da Silva (WI),2020-2023,24,45,98,92,6,92,0,7 (7ct 0st),2.177,
GRA Langley (AUS),1951-1956,26,51,98,83,15,83,0,5 (5ct 0st),1.921,
LEG Ames (ENG),1929-1939,47,87,97,74,23,72,2,4 (4ct 0st),1.114,
PD Collingwood (ENG),2003-2011,68,124,96,96,0,1,95,4 (4ct 0st),0.774,
CH Gayle (WI),2000-2014,103,190,96,96,0,0,96,3 (3ct 0st),0.505,
CG Greenidge (WI),1974-1991,108,208,96,96,0,0,96,3 (3ct 0st),0.461,
KJ Wadsworth (NZ),1969-1976,33,59,96,92,4,92,0,5 (5ct 0st),1.627,
ME Trescothick (ENG),2000-2006,76,139,95,95,0,0,95,4 (4ct 0st),0.683,
AT Carey (AUS),2021-2023,25,46,94,87,7,87,0,6 (6ct 0st),2.043,
HH Gibbs (SA),1996-2008,90,173,94,94,0,0,94,4 (4ct 0st),0.543,
Javed Miandad (PAK),1976-1993,124,218,94,93,1,0,93,3 (3ct 0st),0.431,
LD Chandimal (SL),2011-2023,76,140,93,83,10,63,20,6 (5ct 1st),0.664,
Imtiaz Ahmed (PAK),1952-1962,41,69,93,77,16,74,3,5 (4ct 1st),1.347,
AFA Lilley (ENG),1896-1909,35,67,92,70,22,70,0,4 (4ct 0st),1.373,
D Elgar (SA),2012-2023,84,154,91,91,0,0,91,3 (3ct 0st),0.590,
V Sehwag (ICC/IND),2001-2013,104,192,91,91,0,0,91,3 (3ct 0st),0.473,
FCM Alexander (WI),1957-1961,25,47,90,85,5,85,0,5 (5ct 0st),1.914,
SO Dowrich (WI),2015-2020,35,61,90,85,5,85,0,4 (4ct 0st),1.475,
GA Hick (ENG),1991-2001,65,115,90,90,0,0,90,4 (4ct 0st),0.782,
CH Lloyd (WI),1966-1985,110,209,90,90,0,0,90,2 (2ct 0st),0.430,
RB Richardson (WI),1983-1995,86,164,90,90,0,0,90,3 (3ct 0st),0.548,
TM Dilshan (SL),1999-2013,87,159,88,88,0,11,77,4 (4ct 0st),0.553,
AW Greig (ENG),1972-1977,58,107,87,87,0,0,87,4 (4ct 0st),0.813,
Khaled Mashud (BAN),2000-2007,44,61,87,78,9,78,0,4 (4ct 0st),1.426,
TWM Latham (NZ),2014-2023,74,144,86,86,0,8,78,4 (4ct 0st),0.597,
MEK Hussey (AUS),2005-2013,79,153,85,85,0,0,85,3 (3ct 0st),0.555,
BKG Mendis (SL),2015-2023,60,108,85,85,0,5,80,4 (4ct 0st),0.787,
MS Wade (AUS),2012-2021,36,70,85,74,11,63,11,5 (4ct 1st),1.214,
DA Warner (AUS),2011-2023,109,209,85,85,0,1,84,4 (4ct 0st),0.406,
MA Atherton (ENG),1989-2001,115,200,83,83,0,0,83,3 (3ct 0st),0.415,
G Kirsten (SA),1993-2004,101,191,83,83,0,0,83,4 (4ct 0st),0.434,
IR Redpath (AUS),1964-1976,66,123,83,83,0,0,83,3 (3ct 0st),0.674,
FM Engineer (IND),1961-1975,46,83,82,66,16,66,0,3 (3ct 0st),0.987,
KS Williamson (NZ),2010-2023,94,179,82,82,0,0,82,3 (3ct 0st),0.458,
CO Browne (WI),1995-2005,20,36,81,79,2,79,0,5 (5ct 0st),2.250,
Inzamam-ul-Haq (ICC/PAK),1992-2007,120,219,81,81,0,0,81,4 (4ct 0st),0.369,
TW Graveney (ENG),1951-1969,79,152,80,80,0,2,78,3 (3ct 0st),0.526,
Litton Das (BAN),2015-2023,39,64,80,72,8,62,10,4 (4ct 0st),1.250,
TA Blundell (NZ),2017-2023,26,52,78,68,10,65,3,5 (3ct 2st),1.500,
ST Jayasuriya (SL),1991-2007,110,196,78,78,0,0,78,3 (3ct 0st),0.397,
DB Vengsarkar (IND),1976-1992,116,202,78,78,0,0,78,4 (4ct 0st),0.386,
Adnan Akmal (PAK),2010-2014,21,41,77,66,11,66,0,6 (6ct 0st),1.878,
Asad Shafiq (PAK),2010-2020,77,144,77,77,0,0,77,3 (3ct 0st),0.534,
PR Downton (ENG),1981-1988,30,51,75,70,5,70,0,4 (4ct 0st),1.470,
AJ Lamb (ENG),1982-1992,79,146,75,75,0,0,75,4 (4ct 0st),0.513,
DI Gower (ENG),1978-1992,117,211,74,74,0,0,74,3 (3ct 0st),0.350,
JL Langer (AUS),1993-2007,105,206,73,73,0,0,73,2 (2ct 0st),0.354,
AD Mathews (SL),2009-2023,106,192,73,73,0,0,73,3 (3ct 0st),0.380,
Mohammad Rizwan (PAK),2016-2023,28,49,73,70,3,69,1,4 (4ct 0st),1.489,
TG Southee (NZ),2008-2023,94,181,73,73,0,0,73,2 (2ct 0st),0.403,
H Strudwick (ENG),1910-1926,28,50,73,61,12,61,0,4 (2ct 2st),1.460,
M Muralidaran (ICC/SL),1992-2010,133,233,72,72,0,0,72,2 (2ct 0st),0.309,
PA Patel (IND),2002-2018,25,47,72,62,10,62,0,4 (4ct 0st),1.531,
SM Pollock (SA),1995-2008,108,205,72,72,0,0,72,3 (3ct 0st),0.351,
MD Crowe (NZ),1982-1995,77,130,71,71,0,0,71,4 (4ct 0st),0.546,
SC Ganguly (IND),1996-2008,113,208,71,71,0,0,71,3 (3ct 0st),0.341,
NJ Astle (NZ),1996-2006,81,147,70,70,0,0,70,2 (2ct 0st),0.476,
Majid Khan (PAK),1964-1983,63,116,70,70,0,5,65,4 (4ct 0st),0.603,
DJ Cullinan (SA),1993-2001,70,130,67,67,0,0,67,3 (3ct 0st),0.515,
N Hussain (ENG),1990-2004,96,165,67,67,0,0,67,3 (3ct 0st),0.406,
Azhar Ali (PAK),2010-2022,97,181,66,66,0,0,66,3 (3ct 0st),0.364,
S Chanderpaul (WI),1994-2015,164,297,66,66,0,0,66,2 (2ct 0st),0.222,
CA Pujara (IND),2010-2023,103,199,66,66,0,0,66,3 (3ct 0st),0.331,
R Benaud (AUS),1952-1964,63,122,65,65,0,0,65,3 (3ct 0st),0.532,
H Carter (AUS),1907-1921,28,55,65,44,21,44,0,4 (4ct 0st),1.181,
DL Haynes (WI),1978-1994,116,221,65,65,0,0,65,2 (2ct 0st),0.294,
Mohammad Yousuf (PAK),1998-2010,90,168,65,65,0,0,65,3 (3ct 0st),0.386,
Saleem Malik (PAK),1982-1999,103,184,65,65,0,0,65,3 (3ct 0st),0.353,
DJG Sammy (WI),2007-2013,38,68,65,65,0,0,65,5 (5ct 0st),0.955,
JV Coney (NZ),1974-1987,52,97,64,64,0,0,64,3 (3ct 0st),0.659,
DM de Silva (SL),2016-2023,51,91,64,64,0,0,64,4 (4ct 0st),0.703,
RN Harvey (AUS),1948-1963,79,152,64,64,0,0,64,4 (4ct 0st),0.421,
N Kapil Dev (IND),1978-1994,131,230,64,64,0,0,64,2 (2ct 0st),0.278,
FS Trueman (ENG),1952-1965,67,128,64,64,0,0,64,3 (3ct 0st),0.500,
CL Walcott (WI),1948-1960,44,82,64,53,11,27,26,4 (3ct 1st),0.780,
FE Woolley (ENG),1909-1934,64,113,64,64,0,1,63,4 (4ct 0st),0.566,
F du Plessis (SA),2012-2021,69,128,63,63,0,0,63,3 (3ct 0st),0.492,
BT Foakes (ENG),2018-2023,20,38,63,57,6,57,0,4 (4ct 0st),1.657,
KD Karthik (IND),2004-2018,26,49,63,57,6,51,6,4 (4ct 0st),1.285,
JJ Kelly (AUS),1896-1905,36,67,63,43,20,43,0,4 (4ct 0st),0.940,
PM Nevill (AUS),2015-2016,17,31,63,61,2,61,0,4 (4ct 0st),2.032,
GR Viswanath (IND),1969-1983,91,159,63,63,0,0,63,3 (3ct 0st),0.396,
RC Fredericks (WI),1968-1977,59,112,62,62,0,0,62,4 (4ct 0st),0.553,
JO Holder (WI),2014-2023,64,114,62,62,0,0,62,3 (3ct 0st),0.543,
DA Murray (WI),1978-1982,19,34,62,57,5,57,0,5 (5ct 0st),1.823,
KP Pietersen (ENG),2005-2014,104,193,62,62,0,0,62,3 (3ct 0st),0.321,
T Taibu (ZIM),2001-2012,28,42,62,57,5,55,2,4 (4ct 0st),1.476,
JM Blackham (AUS),1877-1894,35,62,61,37,24,35,2,4 (2ct 2st),0.983,
MA Butcher (ENG),1997-2004,71,122,61,61,0,0,61,3 (3ct 0st),0.500,
ADR Campbell (ZIM),1992-2002,60,105,60,60,0,0,60,3 (3ct 0st),0.571,
G Duckworth (ENG),1924-1936,24,43,60,45,15,45,0,4 (4ct 0st),1.395,
A Kumble (IND),1990-2008,132,242,60,60,0,0,60,2 (2ct 0st),0.247,
W Rhodes (ENG),1899-1930,58,110,60,60,0,0,60,4 (4ct 0st),0.545,
HB Taber (AUS),1966-1970,16,30,60,56,4,56,0,5 (5ct 0st),2.000,
MW Gatting (ENG),1978-1995,79,135,59,59,0,0,59,3 (3ct 0st),0.437,
WK Lees (NZ),1976-1983,21,42,59,52,7,52,0,5 (5ct 0st),1.404,
DT Lindsay (SA),1963-1970,19,36,59,57,2,54,3,6 (6ct 0st),1.638,
GAR Lock (ENG),1952-1968,49,93,59,59,0,0,59,3 (3ct 0st),0.634,
MS Atapattu (SL),1990-2007,90,159,58,58,0,0,58,3 (3ct 0st),0.364,
KF Barrington (ENG),1955-1968,82,153,58,58,0,0,58,3 (3ct 0st),0.379,
NM Lyon (AUS),2011-2023,122,235,58,58,0,0,58,2 (2ct 0st),0.246,
D Tallon (AUS),1946-1953,21,42,58,50,8,50,0,4 (4ct 0st),1.380,
DL Vettori (ICC/NZ),1997-2014,113,205,58,58,0,0,58,3 (3ct 0st),0.282,
L Hutton (ENG),1937-1955,79,147,57,57,0,0,57,3 (3ct 0st),0.387,
AL Logie (WI),1983-1991,52,98,57,57,0,0,57,4 (4ct 0st),0.581,
FDM Karunaratne (SL),2012-2023,88,161,56,56,0,0,56,3 (3ct 0st),0.347,
RS Mahanama (SL),1986-1998,52,81,56,56,0,0,56,4 (4ct 0st),0.691,
B Mitchell (SA),1929-1949,42,71,56,56,0,0,56,4 (4ct 0st),0.788,
SCJ Broad (ENG),2007-2023,167,315,55,55,0,0,55,2 (2ct 0st),0.174,
JT Murray (ENG),1961-1967,21,38,55,52,3,52,0,6 (6ct 0st),1.447,
KWR Fletcher (ENG),1968-1982,59,106,54,54,0,0,54,3 (3ct 0st),0.509,
SD Hope (WI),2015-2021,38,69,54,53,1,9,44,5 (5ct 0st),0.782,
BN Jarman (AUS),1959-1969,19,36,54,50,4,50,0,4 (4ct 0st),1.500,
ND McKenzie (SA),2000-2009,58,111,54,54,0,0,54,3 (3ct 0st),0.486,
KL Rahul (IND),2014-2023,47,91,54,54,0,1,53,4 (4ct 0st),0.593,
CMW Read (ENG),1999-2007,15,26,54,48,6,48,0,6 (6ct 0st),2.076,
GP Swann (ENG),2008-2013,60,113,54,54,0,0,54,3 (3ct 0st),0.477,
BA Young (NZ),1993-1999,35,58,54,54,0,0,54,3 (3ct 0st),0.931,
RR Sarwan (WI),2000-2011,87,162,53,53,0,0,53,2 (2ct 0st),0.327,
MJK Smith (ENG),1958-1972,50,91,53,53,0,0,53,3 (3ct 0st),0.582,
ED Solkar (IND),1969-1977,27,50,53,53,0,0,53,4 (4ct 0st),1.060,
JM Brearley (ENG),1976-1981,39,75,52,52,0,0,52,3 (3ct 0st),0.693,
A Flintoff (ENG/ICC),1998-2009,79,144,52,52,0,0,52,3 (3ct 0st),0.361,
LR Gibbs (WI),1958-1976,79,151,52,52,0,0,52,3 (3ct 0st),0.344,
WB Phillips (AUS),1983-1986,27,43,52,52,0,43,9,5 (5ct 0st),1.209,
RP Arnold (SL),1997-2004,44,77,51,51,0,0,51,4 (4ct 0st),0.662,
DM Bravo (WI),2010-2020,56,96,51,51,0,0,51,5 (5ct 0st),0.531,
HB Cameron (SA),1927-1935,26,45,51,39,12,39,0,4 (2ct 2st),1.133,
RW Chakabva (ZIM),2011-2021,22,38,51,46,5,45,1,5 (5ct 0st),1.342,
AE Dick (NZ),1961-1965,17,30,51,47,4,47,0,4 (4ct 0st),1.700,
AI Kallicharran (WI),1972-1981,66,124,51,51,0,0,51,2 (2ct 0st),0.411,
RG Sharma (IND),2013-2023,52,102,51,51,0,0,51,3 (3ct 0st),0.500,
NS Tamhane (IND),1955-1961,21,35,51,35,16,35,0,4 (4ct 0st),1.457,
Z Crawley (ENG),2019-2023,39,74,50,50,0,0,50,4 (4ct 0st),0.675,
MJ Guptill (NZ),2009-2016,47,88,50,50,0,0,50,3 (3ct 0st),0.568,
KJ Hughes (AUS),1977-1984,70,126,50,50,0,0,50,3 (3ct 0st),0.396,
RB Kanhai (WI),1957-1974,79,147,50,50,0,6,44,3 (3ct 0st),0.340,
Misbah-ul-Haq (PAK),2001-2017,75,143,50,50,0,0,50,3 (3ct 0st),0.349,
DCS Compton (ENG),1937-1957,78,146,49,49,0,0,49,2 (2ct 0st),0.335,
BM McMillan (SA),1992-1998,38,70,49,49,0,0,49,3 (3ct 0st),0.700,
OJ Pope (ENG),2018-2023,38,72,49,48,1,12,36,4 (4ct 0st),0.680,
SJ Rhodes (ENG),1994-1995,11,22,49,46,3,46,0,4 (4ct 0st),2.227,
M Vijay (IND),2008-2018,61,115,49,49,0,0,49,2 (2ct 0st),0.426,
ED Weekes (WI),1948-1958,48,90,49,49,0,0,49,4 (4ct 0st),0.544,
JC Adams (WI),1992-2001,54,99,48,48,0,0,48,4 (4ct 0st),0.484,
CS Baugh (WI),2003-2012,21,38,48,43,5,43,0,5 (4ct 1st),1.263,
TL Goddard (SA),1955-1970,41,77,48,48,0,0,48,4 (4ct 0st),0.623,
Mudassar Nazar (PAK),1976-1989,76,133,48,48,0,0,48,2 (2ct 0st),0.360,
Taufeeq Umar (PAK),2001-2014,44,83,48,48,0,4,44,4 (4ct 0st),0.578,
M Amarnath (IND),1969-1988,69,115,47,47,0,0,47,3 (3ct 0st),0.408,
SL Campbell (WI),1995-2002,52,92,47,47,0,0,47,3 (3ct 0st),0.510,
JL Hendriks (WI),1962-1969,20,37,47,42,5,42,0,4 (2ct 2st),1.270,
UT Khawaja (AUS),2011-2023,66,123,47,47,0,0,47,3 (3ct 0st),0.382,
AG Prince (SA),2002-2011,66,124,47,47,0,0,47,3 (3ct 0st),0.379,
A Ranatunga (SL),1982-2000,93,148,47,47,0,0,47,3 (3ct 0st),0.317,
SJ Rixon (AUS),1977-1985,13,24,47,42,5,42,0,4 (4ct 0st),1.958,
KR Stackpole (AUS),1966-1974,43,83,47,47,0,0,47,3 (3ct 0st),0.566,
AL Wadekar (IND),1966-1974,37,69,46,46,0,0,46,4 (4ct 0st),0.666,
J Blackwood (WI),2014-2023,56,99,45,45,0,0,45,5 (5ct 0st),0.454,
GS Blewett (AUS),1995-2000,46,90,45,45,0,0,45,3 (3ct 0st),0.500,
Ijaz Ahmed (PAK),1987-2001,60,110,45,45,0,0,45,3 (3ct 0st),0.409,
R Illingworth (ENG),1958-1973,61,115,45,45,0,0,45,3 (3ct 0st),0.391,
Mohammad Hafeez (PAK),2003-2018,55,107,45,45,0,0,45,2 (2ct 0st),0.420,
TT Samaraweera (SL),2001-2013,81,145,45,45,0,0,45,3 (3ct 0st),0.310,
H Trumble (AUS),1890-1904,32,61,45,45,0,0,45,3 (3ct 0st),0.737,
SR Watson (AUS),2005-2015,59,113,45,45,0,0,45,3 (3ct 0st),0.398,
WW Armstrong (AUS),1902-1921,50,96,44,44,0,0,44,2 (2ct 0st),0.458,
BE Congdon (NZ),1965-1978,61,110,44,44,0,1,43,3 (3ct 0st),0.400,
JR Reid (NZ),1949-1965,58,90,44,43,1,4,39,3 (3ct 0st),0.488,
DL Underwood (ENG),1966-1982,86,157,44,44,0,0,44,3 (3ct 0st),0.280,
MP Vaughan (ENG),1999-2008,82,150,44,44,0,0,44,3 (3ct 0st),0.293,
S Venkataraghavan (IND),1965-1983,57,101,44,44,0,0,44,4 (4ct 0st),0.435,
Wasim Akram (PAK),1985-2002,104,186,44,44,0,0,44,3 (3ct 0st),0.236,
TA Boult (NZ),2011-2022,78,149,43,43,0,0,43,2 (2ct 0st),0.288,
PA de Silva (SL),1984-2002,93,149,43,43,0,0,43,4 (4ct 0st),0.288,
JH Edrich (ENG),1963-1976,77,145,43,43,0,0,43,2 (2ct 0st),0.296,
GW Flower (ZIM),1992-2004,67,114,43,43,0,0,43,3 (3ct 0st),0.377,
AW Nourse (SA),1902-1924,45,78,43,43,0,0,43,4 (4ct 0st),0.551,
KD Walters (AUS),1965-1981,74,142,43,43,0,0,43,2 (2ct 0st),0.302,
FMM Worrell (WI),1948-1963,51,98,43,43,0,0,43,3 (3ct 0st),0.438,
AK Davidson (AUS),1953-1963,44,85,42,42,0,0,42,4 (4ct 0st),0.494,
PH Edmonds (ENG),1975-1987,51,91,42,42,0,0,42,4 (4ct 0st),0.461,
J Garner (WI),1977-1987,58,111,42,42,0,0,42,3 (3ct 0st),0.378,
Harbhajan Singh (IND),1998-2015,103,192,42,42,0,0,42,2 (2ct 0st),0.218,
Iqbal Qasim (PAK),1976-1988,50,89,42,42,0,0,42,3 (3ct 0st),0.471,
PBH May (ENG),1951-1961,66,127,42,42,0,0,42,4 (4ct 0st),0.330,
Mushtaq Mohammad (PAK),1959-1979,57,102,42,42,0,0,42,2 (2ct 0st),0.411,
PH Parfitt (ENG),1961-1972,37,73,42,42,0,0,42,4 (4ct 0st),0.575,
GM Turner (NZ),1969-1983,41,75,42,42,0,0,42,2 (2ct 0st),0.560,
K Verreynne (SA),2021-2023,14,24,42,39,3,37,2,5 (5ct 0st),1.750,
D Williams (WI),1992-1998,11,19,42,40,2,40,0,5 (5ct 0st),2.210,
KC Brathwaite (WI),2011-2023,87,156,41,41,0,0,41,2 (2ct 0st),0.262,
DJ Bravo (WI),2004-2010,40,71,41,41,0,0,41,3 (3ct 0st),0.577,
JJ Crowe (NZ),1983-1990,39,69,41,41,0,0,41,4 (4ct 0st),0.594,
WR Endean (SA),1951-1958,28,52,41,41,0,3,38,3 (3ct 0st),0.788,
RA Jadeja (IND),2012-2023,67,130,41,41,0,0,41,3 (3ct 0st),0.315,
SJ McCabe (AUS),1930-1938,39,73,41,41,0,0,41,3 (3ct 0st),0.561,
GM Wood (AUS),1978-1988,59,108,41,41,0,0,41,2 (2ct 0st),0.379,
MM Ali (ENG),2014-2023,68,129,40,40,0,0,40,4 (4ct 0st),0.310,
Hanif Mohammad (PAK),1952-1969,55,95,40,40,0,2,38,4 (4ct 0st),0.421,
Imran Farhat (PAK),2001-2013,40,72,40,40,0,0,40,2 (2ct 0st),0.555,
K Srikkanth (IND),1981-1992,43,78,40,40,0,0,40,5 (5ct 0st),0.512,
LC Braund (ENG),1901-1908,23,44,39,39,0,0,39,4 (4ct 0st),0.886,
WJ Edrich (ENG),1938-1955,39,70,39,39,0,0,39,3 (3ct 0st),0.557,
BN French (ENG),1986-1988,16,25,39,38,1,38,0,4 (4ct 0st),1.560,
WG Grace (ENG),1880-1899,22,42,39,39,0,1,38,3 (3ct 0st),0.928,
Sir RJ Hadlee (NZ),1973-1990,86,156,39,39,0,0,39,2 (2ct 0st),0.250,
SM Katich (AUS),2001-2010,56,109,39,39,0,0,39,2 (2ct 0st),0.357,
Mahmudullah (BAN),2009-2021,50,87,39,38,1,0,38,3 (3ct 0st),0.448,
Mominul Haque (BAN),2013-2023,57,97,39,39,0,0,39,3 (3ct 0st),0.402,
MR Ramprakash (ENG),1991-2002,52,93,39,39,0,0,39,3 (3ct 0st),0.419,
RA Smith (ENG),1988-1996,62,110,39,39,0,0,39,3 (3ct 0st),0.354,
RGD Willis (ENG),1971-1984,90,165,39,39,0,0,39,2 (2ct 0st),0.236,
CPS Chauhan (IND),1969-1981,40,71,38,38,0,0,38,3 (3ct 0st),0.535,
JP Duminy (SA),2008-2017,46,83,38,38,0,0,38,3 (3ct 0st),0.457,
G Gambhir (IND),2004-2016,58,104,38,38,0,0,38,2 (2ct 0st),0.365,
GD McGrath (AUS),1993-2007,124,244,38,38,0,0,38,2 (2ct 0st),0.155,
GR Marsh (AUS),1985-1992,50,89,38,38,0,0,38,2 (2ct 0st),0.426,
KR Miller (AUS),1946-1956,55,105,38,38,0,0,38,2 (2ct 0st),0.361,
JG Wright (NZ),1978-1993,82,145,38,38,0,0,38,3 (3ct 0st),0.262,
CG Borde (IND),1958-1969,55,96,37,37,0,0,37,3 (3ct 0st),0.385,
JM Gregory (AUS),1920-1928,24,44,37,37,0,0,37,3 (3ct 0st),0.840,
Aamer Sohail (PAK),1992-2000,47,87,36,36,0,0,36,3 (3ct 0st),0.413,
Asif Iqbal (PAK),1964-1980,58,110,36,36,0,0,36,2 (2ct 0st),0.327,
Babar Azam (PAK),2016-2023,49,91,36,36,0,0,36,2 (2ct 0st),0.395,
RA Harper (WI),1983-1993,25,49,36,36,0,0,36,3 (3ct 0st),0.734,
AC Hudson (SA),1992-1998,35,63,36,36,0,0,36,4 (4ct 0st),0.571,
DR Martyn (AUS),1992-2006,67,130,36,36,0,0,36,2 (2ct 0st),0.276,
RJ Shastri (IND),1981-1992,80,140,36,36,0,0,36,2 (2ct 0st),0.257,
PW Sherwell (SA),1906-1911,13,24,36,20,16,20,0,3 (3ct 0st),1.500,
DS Smith (WI),2003-2018,43,79,36,36,0,0,36,3 (3ct 0st),0.455,
HDRL Thirimanne (SL),2011-2022,44,82,36,36,0,0,36,5 (5ct 0st),0.439,
EJ Barlow (SA),1961-1970,30,58,35,35,0,0,35,3 (3ct 0st),0.603,
Imrul Kayes (BAN),2008-2019,39,67,35,35,0,5,30,5 (5ct 0st),0.522,
GRJ Roope (ENG),1973-1978,21,37,35,35,0,0,35,3 (3ct 0st),0.945,
JK Silva (SL),2011-2018,39,75,35,34,1,6,28,2 (2ct 0st),0.466,
MA Starc (AUS),2011-2023,82,158,35,35,0,0,35,2 (2ct 0st),0.221,
FJ Titmus (ENG),1955-1975,53,100,35,35,0,0,35,2 (2ct 0st),0.350,
KJ Wright (AUS),1979-1979,10,16,35,31,4,31,0,5 (5ct 0st),2.187,
MG Burgess (NZ),1968-1980,50,94,34,34,0,0,34,2 (2ct 0st),0.361,
SV Carlisle (ZIM),1995-2005,37,62,34,34,0,0,34,3 (3ct 0st),0.548,
SS Das (IND),2000-2002,23,43,34,34,0,0,34,3 (3ct 0st),0.790,
JE Emburey (ENG),1978-1995,64,109,34,34,0,0,34,2 (2ct 0st),0.311,
DM Jones (AUS),1984-1992,52,91,34,34,0,0,34,2 (2ct 0st),0.373,
L Klusener (SA),1996-2004,49,92,34,34,0,0,34,2 (2ct 0st),0.369,
GD McKenzie (AUS),1961-1971,60,113,34,34,0,0,34,2 (2ct 0st),0.300,
AK Markram (SA),2017-2023,35,67,34,34,0,0,34,3 (3ct 0st),0.507,
Mohsin Khan (PAK),1978-1986,48,83,34,34,0,0,34,3 (3ct 0st),0.409,
HM Nicholls (NZ),2016-2023,54,104,34,34,0,0,34,2 (2ct 0st),0.326,
Ramiz Raja (PAK),1984-1997,57,103,34,34,0,0,34,3 (3ct 0st),0.330,
JN Rhodes (SA),1992-2000,52,96,34,34,0,0,34,2 (2ct 0st),0.354,
SAR Silva (SL),1983-1988,9,15,34,33,1,33,0,6 (6ct 0st),2.266,
Zaheer Abbas (PAK),1969-1985,78,139,34,34,0,0,34,3 (3ct 0st),0.244,
G Boycott (ENG),1964-1982,108,193,33,33,0,0,33,2 (2ct 0st),0.170,
WJ Cronje (SA),1992-2000,68,128,33,33,0,0,33,2 (2ct 0st),0.257,
AF Giles (ENG),1998-2006,54,99,33,33,0,0,33,2 (2ct 0st),0.333,
AP Gurusinha (SL),1985-1996,41,66,33,33,0,2,31,2 (2ct 0st),0.500,
EH Hendren (ENG),1920-1935,51,92,33,33,0,0,33,2 (2ct 0st),0.358,
C Hill (AUS),1896-1912,49,93,33,33,0,0,33,3 (3ct 0st),0.354,
HJ Howarth (NZ),1969-1977,30,55,33,33,0,0,33,3 (3ct 0st),0.600,
MH Mankad (IND),1946-1959,44,72,33,33,0,0,33,3 (3ct 0st),0.458,
MJ Slater (AUS),1993-2001,74,143,33,33,0,0,33,4 (4ct 0st),0.230,
PR Umrigar (IND),1948-1962,59,101,33,33,0,0,33,3 (3ct 0st),0.326,
S Abid Ali (IND),1967-1974,29,53,32,32,0,0,32,3 (3ct 0st),0.603,
R Ashwin (IND),2011-2023,94,182,32,32,0,0,32,2 (2ct 0st),0.175,
TE Bailey (ENG),1949-1959,61,118,32,32,0,0,32,2 (2ct 0st),0.271,
DG Bradman (AUS),1928-1948,52,99,32,32,0,0,32,2 (2ct 0st),0.323,
APF Chapman (ENG),1924-1931,26,46,32,32,0,0,32,4 (4ct 0st),0.695,
WW Hinds (WI),2000-2005,45,83,32,32,0,0,32,3 (3ct 0st),0.385,
KR Rutherford (NZ),1985-1995,56,95,32,32,0,0,32,2 (2ct 0st),0.336,
TA Ward (SA),1912-1924,23,37,32,19,13,19,0,3 (3ct 0st),0.864,
TR Ambrose (ENG),2008-2009,11,21,31,31,0,31,0,3 (3ct 0st),1.476,
JG Bracewell (NZ),1980-1990,41,73,31,31,0,0,31,3 (3ct 0st),0.424,
JT Ikin (ENG),1946-1955,18,32,31,31,0,0,31,3 (3ct 0st),0.968,
AN Petersen (SA),2010-2015,36,68,31,31,0,0,31,2 (2ct 0st),0.455,
KOA Powell (WI),2011-2021,44,79,31,31,0,0,31,3 (3ct 0st),0.392,
DW Randall (ENG),1977-1984,47,88,31,31,0,0,31,2 (2ct 0st),0.352,
PK Sen (IND),1948-1952,14,21,31,20,11,20,0,4 (4ct 0st),1.476,
MS Sinclair (NZ),1999-2010,33,61,31,31,0,1,30,3 (3ct 0st),0.508,
VT Trumper (AUS),1899-1912,48,90,31,31,0,0,31,2 (2ct 0st),0.344,
WPUJC Vaas (SL),1994-2009,111,196,31,31,0,0,31,2 (2ct 0st),0.158,
B Yardley (AUS),1978-1983,33,62,31,31,0,0,31,2 (2ct 0st),0.500,
Yuvraj Singh (IND),2003-2012,40,76,31,31,0,0,31,2 (2ct 0st),0.407,
BL Cairns (NZ),1974-1985,43,78,30,30,0,0,30,2 (2ct 0st),0.384,
D Ganga (WI),1998-2008,48,87,30,30,0,0,30,3 (3ct 0st),0.344,
PSP Handscomb (AUS),2016-2023,20,36,30,30,0,0,30,3 (3ct 0st),0.833,
RG Hart (NZ),2002-2003,11,18,30,29,1,29,0,4 (4ct 0st),1.666,
AL Hassett (AUS),1938-1953,43,82,30,30,0,0,30,2 (2ct 0st),0.365,
IWG Johnson (AUS),1946-1956,45,86,30,30,0,0,30,3 (3ct 0st),0.348,
BK Kunderan (IND),1960-1967,18,31,30,23,7,21,2,5 (3ct 2st),0.967,
WM Lawry (AUS),1961-1971,67,127,30,30,0,0,30,2 (2ct 0st),0.236,
AA Mallett (AUS),1968-1980,38,73,30,30,0,0,30,2 (2ct 0st),0.410,
FLH Mooney (NZ),1949-1954,14,23,30,22,8,22,0,4 (3ct 1st),1.304,
JM Parker (NZ),1973-1980,36,65,30,30,0,0,30,3 (3ct 0st),0.461,
BRM Taylor (ZIM),2004-2021,34,54,30,30,0,3,27,2 (2ct 0st),0.555,
H Verity (ENG),1931-1939,40,75,30,30,0,0,30,2 (2ct 0st),0.400,
KC Wessels (AUS/SA),1982-1994,40,70,30,30,0,0,30,2 (2ct 0st),0.428,
PR Adams (SA),1995-2004,45,85,29,29,0,0,29,3 (3ct 0st),0.341,
JP Crawley (ENG),1994-2003,37,65,29,29,0,0,29,2 (2ct 0st),0.446,
PJ Cummins (AUS),2011-2023,55,104,29,29,0,0,29,2 (2ct 0st),0.278,
ER Dexter (ENG),1958-1968,62,116,29,29,0,0,29,2 (2ct 0st),0.250,
BL D'Oliveira (ENG),1966-1972,44,83,29,29,0,0,29,3 (3ct 0st),0.349,
LK Germon (NZ),1995-1997,12,19,29,27,2,27,0,4 (4ct 0st),1.526,
GP Howarth (NZ),1975-1985,47,86,29,29,0,0,29,2 (2ct 0st),0.337,
M Labuschagne (AUS),2018-2023,43,81,29,29,0,0,29,3 (3ct 0st),0.358,
AC MacLaren (ENG),1894-1909,35,64,29,29,0,0,29,2 (2ct 0st),0.453,
H Masakadza (ZIM),2001-2018,38,63,29,29,0,0,29,3 (3ct 0st),0.460,
K Rabada (SA),2015-2023,60,109,29,29,0,0,29,2 (2ct 0st),0.266,
JA Rudolph (SA),2003-2012,48,92,29,29,0,0,29,2 (2ct 0st),0.315,
A Shrewsbury snr (ENG),1881-1893,23,42,29,29,0,0,29,3 (3ct 0st),0.690,
IJL Trott (ENG),2009-2015,52,99,29,29,0,0,29,2 (2ct 0st),0.292,
CA Walsh (WI),1984-2001,132,244,29,29,0,0,29,2 (2ct 0st),0.118,
T Bavuma (SA),2014-2023,56,101,28,28,0,0,28,2 (2ct 0st),0.277,
LN Constantine (WI),1928-1939,18,29,28,28,0,0,28,3 (3ct 0st),0.965,
MH Denness (ENG),1969-1975,28,50,28,28,0,0,28,2 (2ct 0st),0.560,
S Dhawan (IND),2013-2018,34,66,28,28,0,0,28,2 (2ct 0st),0.424,
Imran Khan (PAK),1971-1992,88,158,28,28,0,0,28,3 (3ct 0st),0.177,
GA Lohmann (ENG),1886-1896,18,36,28,28,0,0,28,3 (3ct 0st),0.777,
Sadiq Mohammad (PAK),1969-1981,41,74,28,28,0,0,28,2 (2ct 0st),0.378,
MN Samuels (WI),2000-2016,71,127,28,28,0,0,28,2 (2ct 0st),0.220,
JB Statham (ENG),1951-1965,70,134,28,28,0,0,28,2 (2ct 0st),0.208,
TM Alderman (AUS),1981-1991,41,75,27,27,0,0,27,2 (2ct 0st),0.360,
J Darling (AUS),1894-1905,34,63,27,27,0,0,27,3 (3ct 0st),0.428,
HH Dippenaar (SA),1999-2007,38,72,27,27,0,0,27,2 (2ct 0st),0.375,
JN Gillespie (AUS),1996-2006,71,141,27,27,0,0,27,1 (1ct 0st),0.191,
MJ Greatbatch (NZ),1988-1996,41,64,27,27,0,0,27,3 (3ct 0st),0.421,
W Jaffer (IND),2000-2008,31,58,27,27,0,0,27,3 (3ct 0st),0.465,
MG Johnson (AUS),2007-2015,73,141,27,27,0,0,27,4 (4ct 0st),0.191,
PG Joshi (IND),1951-1960,12,20,27,18,9,18,0,4 (2ct 2st),1.350,
NT Paranavitana (SL),2009-2012,32,53,27,27,0,0,27,2 (2ct 0st),0.509,
MAK Pataudi (IND),1961-1975,46,84,27,27,0,0,27,2 (2ct 0st),0.321,
MDKJ Perera (SL),2015-2021,22,42,27,19,8,14,5,3 (3ct 0st),0.642,
CL Vincent (SA),1927-1935,25,43,27,27,0,0,27,2 (2ct 0st),0.627,
SC Williams (WI),1994-2002,31,53,27,27,0,0,27,2 (2ct 0st),0.509,
BS Bedi (IND),1966-1979,67,121,26,26,0,0,26,1 (1ct 0st),0.214,
AV Bedser (ENG),1946-1955,51,93,26,26,0,0,26,2 (2ct 0st),0.279,
DR Jardine (ENG),1928-1934,22,42,26,26,0,0,26,3 (3ct 0st),0.619,
NV Knight (ENG),1995-2001,17,31,26,26,0,0,26,4 (4ct 0st),0.838,
RR Lindwall (AUS),1946-1960,61,117,26,26,0,0,26,2 (2ct 0st),0.222,
SV Manjrekar (IND),1987-1996,37,68,26,25,1,0,25,3 (3ct 0st),0.382,
MA Noble (AUS),1898-1909,42,79,26,26,0,0,26,3 (3ct 0st),0.329,
MH Richardson (NZ),2000-2004,38,68,26,26,0,0,26,2 (2ct 0st),0.382,
Sarfraz Nawaz (PAK),1969-1984,55,98,26,26,0,0,26,3 (3ct 0st),0.265,
Shakib Al Hasan (BAN),2007-2023,66,116,26,26,0,0,26,2 (2ct 0st),0.224,
PV Simmons (WI),1988-1997,26,48,26,26,0,0,26,2 (2ct 0st),0.541,
DW Steyn (SA),2004-2019,93,175,26,26,0,0,26,2 (2ct 0st),0.148,
RF Surti (IND),1960-1969,26,47,26,26,0,0,26,3 (3ct 0st),0.553,
R Swetman (ENG),1959-1960,11,19,26,24,2,24,0,4 (4ct 0st),1.368,
HJ Tayfield (SA),1949-1960,37,67,26,26,0,0,26,2 (2ct 0st),0.388,
Anil Dalpat (PAK),1984-1985,9,15,25,22,3,22,0,3 (3ct 0st),1.666,
BS Chandrasekhar (IND),1964-1979,58,102,25,25,0,0,25,2 (2ct 0st),0.245,
PG Fulton (NZ),2006-2014,23,42,25,25,0,0,25,3 (3ct 0st),0.595,
C Green (AUS),2020-2023,24,45,25,25,0,0,25,3 (3ct 0st),0.555,
SE Gregory (AUS),1890-1912,58,107,25,25,0,0,25,2 (2ct 0st),0.233,
M Hendrick (ENG),1974-1981,30,56,25,25,0,0,25,3 (3ct 0st),0.446,
AH Jones (NZ),1987-1995,39,62,25,25,0,0,25,2 (2ct 0st),0.403,
CC Lewis (ENG),1990-1996,32,58,25,25,0,0,25,2 (2ct 0st),0.431,
MD Marshall (WI),1978-1991,81,153,25,25,0,0,25,2 (2ct 0st),0.163,
Mohammad Ashraful (BAN),2001-2013,61,91,25,25,0,0,25,2 (2ct 0st),0.274,
M Morkel (SA),2006-2018,86,160,25,25,0,0,25,2 (2ct 0st),0.156,
M Ntini (SA),1998-2009,101,192,25,25,0,0,25,1 (1ct 0st),0.130,
Nurul Hasan (BAN),2017-2022,9,16,25,18,7,18,0,3 (3ct 0st),1.562,
EC Petrie (NZ),1955-1966,14,18,25,25,0,25,0,4 (4ct 0st),1.388,
DL Amiss (ENG),1966-1977,50,90,24,24,0,0,24,2 (2ct 0st),0.266,
RJ Burns (ENG),2018-2022,32,62,24,24,0,0,24,2 (2ct 0st),0.387,
DB Close (ENG),1949-1976,22,44,24,24,0,0,24,3 (3ct 0st),0.545,
EJM Cowan (AUS),2011-2013,18,35,24,24,0,0,24,3 (3ct 0st),0.685,
PB Dassanayake (SL),1993-1994,11,14,24,19,5,19,0,5 (5ct 0st),1.714,
GC Dyer (AUS),1986-1988,6,11,24,22,2,22,0,4 (4ct 0st),2.181,
G Giffen (AUS),1881-1896,31,55,24,24,0,0,24,3 (3ct 0st),0.436,
HMRKB Herath (SL),1999-2018,93,172,24,24,0,0,24,2 (2ct 0st),0.139,
MJ Hoggard (ENG),2000-2008,67,125,24,24,0,0,24,2 (2ct 0st),0.192,
C Kelleway (AUS),1910-1928,26,47,24,24,0,0,24,3 (3ct 0st),0.510,
Mehidy Hasan Miraz (BAN),2016-2023,39,70,24,24,0,0,24,2 (2ct 0st),0.342,
DJ Mitchell (NZ),2019-2023,18,35,24,24,0,0,24,3 (3ct 0st),0.685,
Mohammad Wasim (PAK),1996-2000,18,32,24,22,2,1,21,2 (2ct 0st),0.750,
VY Richardson (AUS),1924-1936,19,37,24,24,0,0,24,5 (5ct 0st),0.648,
RA Saggers (AUS),1948-1950,6,11,24,16,8,16,0,4 (1ct 3st),2.181,
SJ Snooke (SA),1906-1923,26,47,24,24,0,0,24,2 (2ct 0st),0.510,
WU Tharanga (SL),2005-2017,31,58,24,24,0,0,24,3 (3ct 0st),0.413,
CFK van Wyk (NZ),2012-2012,9,17,24,23,1,23,0,4 (4ct 0st),1.411,
Yasir Shah (PAK),2014-2022,48,90,24,24,0,0,24,2 (2ct 0st),0.266,
PJP Burge (AUS),1955-1966,42,78,23,23,0,0,23,2 (2ct 0st),0.294,
JA Burns (AUS),2014-2020,23,44,23,23,0,0,23,2 (2ct 0st),0.522,
RL Chase (WI),2016-2023,49,87,23,23,0,0,23,3 (3ct 0st),0.264,
RG de Alwis (SL),1983-1988,11,14,23,21,2,21,0,4 (4ct 0st),1.642,
GT Dowling (NZ),1961-1972,39,71,23,23,0,0,23,3 (3ct 0st),0.323,
BF Hastings (NZ),1969-1976,31,54,23,23,0,0,23,3 (3ct 0st),0.425,
JR Hazlewood (AUS),2014-2023,63,119,23,23,0,0,23,2 (2ct 0st),0.193,
MG Hughes (AUS),1985-1994,53,97,23,23,0,0,23,2 (2ct 0st),0.237,
B Lee (AUS),1999-2008,76,151,23,23,0,0,23,2 (2ct 0st),0.152,
DK Lillee (AUS),1971-1984,70,133,23,23,0,0,23,2 (2ct 0st),0.172,
RA McLean (SA),1951-1964,40,72,23,23,0,0,23,2 (2ct 0st),0.319,
SE Marsh (AUS),2011-2019,38,72,23,23,0,0,23,2 (2ct 0st),0.319,
Mushtaq Ahmed (PAK),1990-2003,52,94,23,23,0,0,23,2 (2ct 0st),0.244,
SK Raina (IND),2010-2015,18,33,23,23,0,0,23,2 (2ct 0st),0.696,
I Sharma (IND),2007-2021,105,194,23,23,0,0,23,2 (2ct 0st),0.118,
Soumya Sarkar (BAN),2015-2021,16,27,23,23,0,0,23,4 (4ct 0st),0.851,
SB Styris (NZ),2002-2007,29,51,23,23,0,0,23,3 (3ct 0st),0.450,
H Sutcliffe (ENG),1924-1935,54,96,23,23,0,0,23,3 (3ct 0st),0.239,
HE van der Dussen (SA),2019-2022,18,33,23,23,0,0,23,3 (3ct 0st),0.696,
GN Yallop (AUS),1976-1984,39,69,23,23,0,0,23,2 (2ct 0st),0.333,
KLT Arthurton (WI),1988-1995,33,62,22,22,0,0,22,2 (2ct 0st),0.354,
Ashraf Ali (PAK),1982-1987,8,14,22,17,5,17,0,4 (2ct 2st),1.571,
GS Ballance (ENG/ZIM),2014-2023,24,48,22,22,0,0,22,3 (3ct 0st),0.458,
IM Barrow (WI),1930-1939,11,16,22,17,5,16,1,3 (3ct 0st),1.375,
FR Brown (ENG),1931-1953,22,40,22,22,0,0,22,2 (2ct 0st),0.550,
Faisal Iqbal (PAK),2001-2010,26,46,22,22,0,0,22,3 (3ct 0st),0.478,
JDC Goddard (WI),1948-1957,27,51,22,22,0,0,22,2 (2ct 0st),0.431,
Habibul Bashar (BAN),2000-2008,50,70,22,22,0,0,22,2 (2ct 0st),0.314,
MA Holding (WI),1975-1987,60,114,22,22,0,0,22,2 (2ct 0st),0.192,
RAS Lakmal (SL),2010-2022,70,130,22,22,0,0,22,1 (1ct 0st),0.169,
CD McMillan (NZ),1997-2005,55,99,22,22,0,0,22,1 (1ct 0st),0.222,
W Mathias (PAK),1955-1962,21,36,22,22,0,0,22,4 (4ct 0st),0.611,
RG Nadkarni (IND),1955-1968,41,73,22,22,0,0,22,2 (2ct 0st),0.301,
CM Old (ENG),1972-1981,46,84,22,22,0,0,22,2 (2ct 0st),0.261,
Shoaib Mohammad (PAK),1983-1995,45,79,22,22,0,0,22,2 (2ct 0st),0.278,
J Srinath (IND),1991-2002,67,122,22,22,0,0,22,2 (2ct 0st),0.180,
A Symonds (AUS),2004-2008,26,52,22,22,0,0,22,3 (3ct 0st),0.423,
AC Bannerman (AUS),1879-1893,28,49,21,21,0,0,21,2 (2ct 0st),0.428,
RW Barber (ENG),1960-1968,28,49,21,21,0,0,21,2 (2ct 0st),0.428,
TE Blain (NZ),1986-1994,11,17,21,19,2,18,1,4 (4ct 0st),1.235,
AR Caddick (ENG),1993-2003,62,106,21,21,0,0,21,2 (2ct 0st),0.198,
RJ Christiani (WI),1948-1954,22,44,21,19,2,1,18,3 (1ct 2st),0.477,
RM Cowper (AUS),1964-1968,27,50,21,21,0,0,21,2 (2ct 0st),0.420,
TM Findlay (WI),1969-1973,10,17,21,19,2,19,0,4 (4ct 0st),1.235,
GB Hole (AUS),1951-1955,18,35,21,21,0,0,21,4 (4ct 0st),0.600,
E Jones (AUS),1894-1902,19,34,21,21,0,0,21,3 (3ct 0st),0.617,
RB McCosker (AUS),1975-1980,25,47,21,21,0,0,21,2 (2ct 0st),0.446,
VL Manjrekar (IND),1951-1965,55,96,21,19,2,2,17,2 (2ct 0st),0.218,
BAG Murray (NZ),1968-1971,13,25,21,21,0,0,21,2 (2ct 0st),0.840,
SM Nurse (WI),1960-1969,29,54,21,21,0,1,20,2 (2ct 0st),0.388,
NCL O'Neill (AUS),1958-1965,42,82,21,21,0,0,21,2 (2ct 0st),0.256,
DG Phadkar (IND),1947-1959,31,50,21,21,0,0,21,2 (2ct 0st),0.420,
WH Ponsford (AUS),1924-1934,29,55,21,21,0,0,21,2 (2ct 0st),0.381,
JA Raval (NZ),2016-2020,24,46,21,21,0,0,21,3 (3ct 0st),0.456,
CJ Richards (ENG),1986-1988,8,15,21,20,1,20,0,5 (5ct 0st),1.400,
KAJ Roach (WI),2009-2023,79,144,21,21,0,0,21,2 (2ct 0st),0.145,
Shan Masood (PAK),2013-2023,30,52,21,21,0,0,21,2 (2ct 0st),0.403,
CM Spearman (NZ),1995-2000,19,38,21,21,0,0,21,2 (2ct 0st),0.552,
Taijul Islam (BAN),2014-2023,42,74,21,21,0,0,21,2 (2ct 0st),0.283,
GHS Trott (AUS),1888-1898,24,44,21,21,0,0,21,2 (2ct 0st),0.477,
GOB Allen (ENG),1930-1948,25,47,20,20,0,0,20,2 (2ct 0st),0.425,
RG Archer (AUS),1953-1956,19,35,20,20,0,0,20,4 (4ct 0st),0.571,
D Bishoo (WI),2011-2018,36,64,20,20,0,0,20,3 (3ct 0st),0.312,
GA Faulkner (SA),1906-1924,25,44,20,20,0,0,20,3 (3ct 0st),0.454,
Intikhab Alam (PAK),1959-1977,47,87,20,20,0,0,20,2 (2ct 0st),0.229,
LV Maddocks (AUS),1954-1956,7,11,20,19,1,19,0,4 (3ct 1st),1.818,
RS Morton (WI),2005-2008,15,26,20,20,0,0,20,2 (2ct 0st),0.769,
M Prabhakar (IND),1984-1995,39,69,20,20,0,0,20,2 (2ct 0st),0.289,
GS Ramchand (IND),1952-1960,33,57,20,20,0,0,20,3 (3ct 0st),0.350,
AC Smith (ENG),1962-1963,6,12,20,20,0,20,0,3 (3ct 0st),1.666,
EJ Smith (ENG),1911-1913,11,20,20,17,3,16,1,3 (3ct 0st),1.000,
JB Stollmeyer (WI),1939-1955,32,63,20,20,0,0,20,2 (2ct 0st),0.317,
B Sutcliffe (NZ),1947-1965,42,61,20,20,0,0,20,2 (2ct 0st),0.327,
Tamim Iqbal (BAN),2008-2023,70,122,20,20,0,0,20,2 (2ct 0st),0.163,
CJ Tavare (ENG),1980-1989,31,56,20,20,0,0,20,1 (1ct 0st),0.357,
JR Thomson (AUS),1972-1985,51,94,20,20,0,0,20,1 (1ct 0st),0.212,
AEE Vogler (SA),1906-1911,15,28,20,20,0,0,20,4 (4ct 0st),0.714,
Wasim Raja (PAK),1973-1985,57,98,20,20,0,0,20,2 (2ct 0st),0.204,
CR Woakes (ENG),2013-2023,48,92,20,20,0,0,20,2 (2ct 0st),0.217,
Yasir Hameed (PAK),2003-2010,25,47,20,20,0,0,20,2 (2ct 0st),0.425,
Asif Mujtaba (PAK),1986-1997,25,44,19,19,0,0,19,2 (2ct 0st),0.431,
W Barnes (ENG),1880-1890,21,40,19,19,0,0,19,3 (3ct 0st),0.475,
MD Bell (NZ),1998-2008,18,33,19,19,0,0,19,2 (2ct 0st),0.575,
C de Grandhomme (NZ),2016-2022,29,57,19,19,0,0,19,2 (2ct 0st),0.333,
TW Hayward (ENG),1896-1909,35,67,19,19,0,0,19,2 (2ct 0st),0.283,
Z Khan (IND),2000-2014,92,173,19,19,0,0,19,2 (2ct 0st),0.109,
CJ McDermott (AUS),1984-1996,71,126,19,19,0,0,19,2 (2ct 0st),0.150,
R Mutumbami (ZIM),2013-2014,6,12,19,17,2,17,0,5 (4ct 1st),1.583,
MDK Perera (SL),2014-2021,43,79,19,19,0,0,19,2 (2ct 0st),0.240,
V Pollard (NZ),1965-1973,32,57,19,19,0,0,19,3 (3ct 0st),0.333,
Shahriar Nafees (BAN),2005-2013,24,38,19,19,0,0,19,2 (2ct 0st),0.500,
PM Siddle (AUS),2008-2019,67,128,19,19,0,0,19,2 (2ct 0st),0.148,
HW Taylor (SA),1912-1932,42,69,19,19,0,0,19,2 (2ct 0st),0.275,
G Ulyett (ENG),1877-1890,25,47,19,19,0,0,19,3 (3ct 0st),0.404,
L Vincent (NZ),2001-2007,23,41,19,19,0,0,19,3 (3ct 0st),0.463,
GJ Whittall (ZIM),1993-2002,46,81,19,19,0,0,19,3 (3ct 0st),0.234,
UT Yadav (IND),2011-2023,57,112,19,19,0,0,19,2 (2ct 0st),0.169,
TJ Zoehrer (AUS),1986-1987,10,16,19,18,1,18,0,3 (3ct 0st),1.187,
DW Allan (WI),1962-1966,5,10,18,15,3,15,0,3 (3ct 0st),1.800,
CEL Ambrose (WI),1988-2000,98,182,18,18,0,0,18,1 (1ct 0st),0.098,
N Boje (SA),2000-2006,43,80,18,18,0,0,18,2 (2ct 0st),0.225,
JW Burke (AUS),1951-1959,24,45,18,18,0,0,18,2 (2ct 0st),0.400,
NJ Contractor (IND),1955-1962,31,54,18,18,0,0,18,2 (2ct 0st),0.333,
DG Cork (ENG),1995-2002,37,65,18,18,0,0,18,2 (2ct 0st),0.276,
Danish Kaneria (PAK),2000-2010,61,115,18,18,0,0,18,1 (1ct 0st),0.156,
AA Donald (SA),1992-2002,72,134,18,18,0,0,18,2 (2ct 0st),0.134,
JS Foster (ENG),2001-2002,7,13,18,17,1,17,0,5 (5ct 0st),1.384,
HA Gomes (WI),1976-1987,60,112,18,18,0,0,18,1 (1ct 0st),0.160,
GE Gomez (WI),1939-1954,29,58,18,18,0,0,18,3 (3ct 0st),0.310,
TM Head (AUS),2018-2023,42,80,18,18,0,0,18,2 (2ct 0st),0.225,
GH Hirst (ENG),1897-1909,24,44,18,18,0,0,18,2 (2ct 0st),0.409,
DAJ Holford (WI),1966-1977,24,42,18,18,0,0,18,2 (2ct 0st),0.428,
JM How (NZ),2006-2009,19,32,18,18,0,0,18,2 (2ct 0st),0.562,
Imam-ul-Haq (PAK),2018-2023,22,41,18,18,0,0,18,4 (4ct 0st),0.439,
AH Jarvis (AUS),1885-1895,11,19,18,9,9,8,1,3 (3ct 0st),0.947,
DJ McGlew (SA),1951-1962,34,63,18,18,0,0,18,3 (3ct 0st),0.285,
JA Maclean (AUS),1978-1979,4,8,18,18,0,18,0,5 (5ct 0st),2.250,
MR Marsh (AUS),2014-2023,35,67,18,18,0,0,18,2 (2ct 0st),0.268,
KD Petersen (SA),2021-2023,11,21,18,18,0,0,18,3 (3ct 0st),0.857,
EAS Prasanna (IND),1962-1978,49,88,18,18,0,0,18,2 (2ct 0st),0.204,
S Ramesh (IND),1999-2001,19,36,18,18,0,0,18,2 (2ct 0st),0.500,
Saeed Anwar (PAK),1990-2001,55,101,18,18,0,0,18,2 (2ct 0st),0.178,
RO Schwarz (SA),1906-1912,20,36,18,18,0,0,18,2 (2ct 0st),0.500,
Shoaib Malik (PAK),2001-2015,35,67,18,18,0,0,18,2 (2ct 0st),0.268,
Waqar Younis (PAK),1989-2003,87,158,18,18,0,0,18,3 (3ct 0st),0.113,
GP Wickramasinghe (SL),1991-2001,40,65,18,18,0,0,18,2 (2ct 0st),0.276,
SFAF Bacchus (WI),1978-1982,19,34,17,17,0,0,17,3 (3ct 0st),0.500,
AP Binns (WI),1953-1956,5,10,17,14,3,14,0,3 (3ct 0st),1.700,
BC Booth (AUS),1961-1966,29,54,17,17,0,0,17,2 (2ct 0st),0.314,
DG Brownlie (NZ),2011-2013,14,25,17,17,0,0,17,4 (4ct 0st),0.680,
AN Connolly (AUS),1963-1971,29,55,17,17,0,0,17,2 (2ct 0st),0.309,
CR Ervine (ZIM),2011-2023,20,34,17,17,0,0,17,4 (4ct 0st),0.500,
CB Fry (ENG),1896-1912,26,47,17,17,0,0,17,2 (2ct 0st),0.361,
JW Gleeson (AUS),1967-1972,29,56,17,17,0,0,17,2 (2ct 0st),0.303,
CV Grimmett (AUS),1925-1936,37,71,17,17,0,0,17,2 (2ct 0st),0.239,
JB Hobbs (ENG),1908-1930,61,110,17,17,0,0,17,2 (2ct 0st),0.154,
MJ Horne (NZ),1997-2003,35,65,17,17,0,0,17,3 (3ct 0st),0.261,
DL Houghton (ZIM),1992-1997,22,40,17,17,0,0,17,3 (3ct 0st),0.425,
ML Jaisimha (IND),1959-1971,39,72,17,17,0,0,17,1 (1ct 0st),0.236,
KK Jennings (ENG),2016-2019,17,32,17,17,0,0,17,4 (4ct 0st),0.531,
CG Macartney (AUS),1907-1926,35,64,17,17,0,0,17,1 (1ct 0st),0.265,
G MacGregor (ENG),1890-1893,8,15,17,14,3,14,0,3 (3ct 0st),1.133,
GRJ Matthews (AUS),1983-1993,33,56,17,17,0,0,17,2 (2ct 0st),0.303,
G Miller (ENG),1976-1984,34,62,17,17,0,0,17,2 (2ct 0st),0.274,
PWA Mulder (SA),2019-2023,12,24,17,17,0,0,17,3 (3ct 0st),0.708,
MJ North (AUS),2009-2010,21,40,17,17,0,0,17,2 (2ct 0st),0.425,
BP Patel (IND),1974-1977,21,37,17,17,0,0,17,3 (3ct 0st),0.459,
R Peel (ENG),1884-1896,20,38,17,17,0,0,17,2 (2ct 0st),0.447,
VD Philander (SA),2011-2020,64,119,17,17,0,0,17,1 (1ct 0st),0.142,
RG Pollock (SA),1963-1970,23,44,17,17,0,0,17,2 (2ct 0st),0.386,
LG Rowe (WI),1972-1980,30,55,17,17,0,0,17,2 (2ct 0st),0.309,
J Ryder (AUS),1920-1929,20,36,17,17,0,0,17,3 (3ct 0st),0.472,
PJ Sharpe (ENG),1963-1969,12,24,17,17,0,0,17,2 (2ct 0st),0.708,
AP Sheahan (AUS),1967-1974,31,60,17,17,0,0,17,1 (1ct 0st),0.283,
HH Streak (ZIM),1993-2005,65,110,17,17,0,0,17,2 (2ct 0st),0.154,
WW Wade (SA),1938-1950,11,18,17,15,2,15,0,3 (3ct 0st),0.944,
N Wagner (NZ),2012-2023,63,121,17,17,0,0,17,2 (2ct 0st),0.140,
JT Ward (NZ),1964-1968,8,15,17,16,1,16,0,4 (4ct 0st),1.133,
AJ Watkins (ENG),1948-1952,15,26,17,17,0,0,17,3 (3ct 0st),0.653,
Aamer Malik (PAK),1987-1994,14,26,16,15,1,4,11,4 (4ct 0st),0.615,
CT Bancroft (AUS),2017-2019,10,19,16,16,0,0,16,3 (3ct 0st),0.842,
AJ Bichel (AUS),1997-2003,19,38,16,16,0,0,16,2 (2ct 0st),0.421,
GJ Bonnor (AUS),1880-1888,17,29,16,16,0,0,16,3 (3ct 0st),0.551,
N Deonarine (WI),2005-2013,18,33,16,16,0,0,16,3 (3ct 0st),0.484,
M Dillon (WI),1997-2004,38,69,16,16,0,0,16,2 (2ct 0st),0.231,
SB Doull (NZ),1992-2000,32,53,16,16,0,0,16,2 (2ct 0st),0.301,
DD Ebrahim (ZIM),2001-2005,29,45,16,16,0,0,16,2 (2ct 0st),0.355,
ST Gabriel (WI),2012-2023,59,105,16,16,0,0,16,2 (2ct 0st),0.152,
KD Ghavri (IND),1974-1981,39,69,16,16,0,0,16,2 (2ct 0st),0.231,
CC Griffith (WI),1960-1969,28,52,16,16,0,0,16,2 (2ct 0st),0.307,
SC Guillen (NZ/WI),1951-1956,8,15,16,13,3,13,0,3 (3ct 0st),1.066,
AJ Hall (SA),2002-2007,21,39,16,16,0,0,16,2 (2ct 0st),0.410,
Haroon Rasheed (PAK),1977-1983,23,41,16,16,0,0,16,2 (2ct 0st),0.390,
PL Harris (SA),2007-2011,37,69,16,16,0,0,16,2 (2ct 0st),0.231,
VA Holder (WI),1969-1979,40,74,16,16,0,0,16,1 (1ct 0st),0.216,
CC Hunte (WI),1958-1967,44,85,16,16,0,0,16,2 (2ct 0st),0.188,
Imran Butt (PAK),2021-2021,6,12,16,16,0,0,16,3 (3ct 0st),1.333,
FA Iredale (AUS),1894-1899,14,27,16,16,0,0,16,3 (3ct 0st),0.592,
KC James (NZ),1930-1933,11,16,16,11,5,11,0,2 (2ct 0st),1.000,
WR James (ZIM),1993-1994,4,7,16,16,0,16,0,5 (5ct 0st),2.285,
WA Johnston (AUS),1947-1955,40,79,16,16,0,0,16,2 (2ct 0st),0.202,
AH Kardar (IND/PAK),1946-1958,26,45,16,16,0,0,16,2 (2ct 0st),0.355,
MS Kasprowicz (AUS),1996-2006,38,75,16,16,0,0,16,2 (2ct 0st),0.213,
BM Laird (AUS),1979-1982,21,37,16,16,0,0,16,2 (2ct 0st),0.432,
MJ Leach (ENG),2018-2023,35,66,16,16,0,0,16,2 (2ct 0st),0.242,
SCG MacGill (AUS),1998-2008,44,87,16,16,0,0,16,2 (2ct 0st),0.183,
KD Mackay (AUS),1956-1963,37,71,16,16,0,0,16,2 (2ct 0st),0.225,
KA Maharaj (SA),2016-2023,49,91,16,16,0,0,16,1 (1ct 0st),0.175,
Mohammed Shami (IND),2013-2023,64,124,16,16,0,0,16,1 (1ct 0st),0.129,
A Nel (SA),2001-2008,36,69,16,16,0,0,16,2 (2ct 0st),0.231,
CS Pandit (IND),1986-1992,5,9,16,14,2,11,3,4 (4ct 0st),1.777,
WW Read (ENG),1882-1893,18,35,16,16,0,0,16,2 (2ct 0st),0.457,
P Roy (IND),1951-1960,43,72,16,16,0,0,16,2 (2ct 0st),0.222,
MJ Santner (NZ),2015-2021,24,46,16,16,0,0,16,2 (2ct 0st),0.347,
V Sibanda (ZIM),2003-2014,14,27,16,16,0,0,16,3 (3ct 0st),0.592,
JA Snow (ENG),1965-1976,49,93,16,16,0,0,16,2 (2ct 0st),0.172,
JT Tyldesley (ENG),1899-1909,31,59,16,16,0,0,16,1 (1ct 0st),0.271,
RES Wyatt (ENG),1927-1937,40,74,16,16,0,0,16,2 (2ct 0st),0.216,
Yashpal Sharma (IND),1979-1983,37,60,16,16,0,0,16,2 (2ct 0st),0.266,
Abdul Qadir (PAK),1977-1990,67,117,15,15,0,0,15,2 (2ct 0st),0.128,
Abdul Razzaq (PAK),1999-2006,46,85,15,15,0,0,15,2 (2ct 0st),0.176,
BF Butcher (WI),1958-1969,44,83,15,15,0,0,15,2 (2ct 0st),0.180,
AG Chipperfield (AUS),1934-1938,14,26,15,15,0,0,15,3 (3ct 0st),0.576,
A Chopra (IND),2003-2004,10,19,15,15,0,0,15,3 (3ct 0st),0.789,
RRS Cornwall (WI),2019-2023,10,18,15,15,0,0,15,3 (3ct 0st),0.833,
CI Dunusinghe (SL),1995-1995,5,9,15,13,2,13,0,4 (4ct 0st),1.666,
KA Edwards (WI),2011-2014,17,32,15,15,0,0,15,2 (2ct 0st),0.468,
AG Fairfax (AUS),1929-1931,10,19,15,15,0,0,15,3 (3ct 0st),0.789,
AD Gaekwad (IND),1974-1985,40,66,15,15,0,0,15,2 (2ct 0st),0.227,
G Gunn (ENG),1907-1930,15,30,15,15,0,0,15,2 (2ct 0st),0.500,
PJ Hughes (AUS),2009-2013,26,48,15,15,0,0,15,2 (2ct 0st),0.312,
AO Jones (ENG),1899-1909,12,23,15,15,0,0,15,2 (2ct 0st),0.652,
H Larwood (ENG),1926-1933,21,38,15,15,0,0,15,4 (4ct 0st),0.394,
S Madan Lal (IND),1974-1986,39,66,15,15,0,0,15,1 (1ct 0st),0.227,
PNF Mansell (SA),1951-1955,13,24,15,15,0,0,15,2 (2ct 0st),0.625,
G Millman (ENG),1961-1962,6,12,15,13,2,13,0,4 (2ct 2st),1.250,
AR Morris (AUS),1946-1955,46,90,15,15,0,0,15,2 (2ct 0st),0.166,
J Mubarak (SL),2002-2015,13,24,15,15,0,0,15,3 (3ct 0st),0.625,
WL Murdoch (AUS/ENG),1877-1892,19,36,15,14,1,3,11,3 (3ct 0st),0.416,
Najmul Hossain Shanto (BAN),2017-2023,23,42,15,15,0,0,15,2 (2ct 0st),0.357,
KJ O'Keeffe (AUS),1971-1977,24,47,15,15,0,0,15,2 (2ct 0st),0.319,
JDP Oram (NZ),2002-2009,33,60,15,15,0,0,15,2 (2ct 0st),0.250,
DN Patel (NZ),1987-1997,37,62,15,15,0,0,15,2 (2ct 0st),0.241,
PI Pocock (ENG),1968-1985,25,46,15,15,0,0,15,3 (3ct 0st),0.326,
MSK Prasad (IND),1999-2000,6,11,15,15,0,15,0,4 (4ct 0st),1.363,
Qasim Umar (PAK),1983-1986,26,42,15,15,0,0,15,2 (2ct 0st),0.357,
Rajin Saleh (BAN),2003-2008,24,37,15,15,0,1,14,3 (3ct 0st),0.405,
PR Reiffel (AUS),1992-1998,35,68,15,15,0,0,15,1 (1ct 0st),0.220,
CJL Rogers (AUS),2008-2015,25,49,15,15,0,0,15,3 (3ct 0st),0.306,
Saqlain Mushtaq (PAK),1995-2004,49,87,15,15,0,0,15,2 (2ct 0st),0.172,
PA Strang (ZIM),1994-2001,24,44,15,15,0,0,15,3 (3ct 0st),0.340,
DR Tuffey (NZ),2000-2010,26,46,15,15,0,0,15,2 (2ct 0st),0.326,
A Turner (AUS),1975-1977,14,27,15,15,0,0,15,4 (4ct 0st),0.555,
W Voce (ENG),1930-1947,27,51,15,15,0,0,15,2 (2ct 0st),0.294,
AC Voges (AUS),2015-2016,20,37,15,15,0,0,15,3 (3ct 0st),0.405,
CB Wishart (ZIM),1995-2005,27,45,15,15,0,0,15,2 (2ct 0st),0.333,
MA Agarwal (IND),2018-2022,21,42,14,14,0,0,14,2 (2ct 0st),0.333,
Azhar Mahmood (PAK),1997-2001,21,37,14,14,0,0,14,3 (3ct 0st),0.378,
RG Barlow (ENG),1881-1887,17,31,14,14,0,0,14,2 (2ct 0st),0.451,
SG Barnes (AUS),1938-1948,13,25,14,14,0,0,14,3 (3ct 0st),0.560,
CJ Barnett (ENG),1933-1948,20,39,14,14,0,0,14,2 (2ct 0st),0.358,
SJ Benn (WI),2008-2015,26,45,14,14,0,0,14,2 (2ct 0st),0.311,
NE Bonner (WI),2021-2022,15,29,14,14,0,0,14,2 (2ct 0st),0.482,
SL Boock (NZ),1978-1989,30,54,14,14,0,0,14,2 (2ct 0st),0.259,
WA Brown (AUS),1934-1948,22,41,14,14,0,0,14,2 (2ct 0st),0.341,
CL Cairns (NZ),1989-2004,62,110,14,14,0,0,14,2 (2ct 0st),0.127,
GJ Cosier (AUS),1975-1978,18,34,14,14,0,0,14,2 (2ct 0st),0.411,
MD Craig (NZ),2014-2016,15,29,14,14,0,0,14,2 (2ct 0st),0.482,
PAJ DeFreitas (ENG),1986-1995,44,78,14,14,0,0,14,2 (2ct 0st),0.179,
HDPK Dharmasena (SL),1993-2004,31,53,14,14,0,0,14,3 (3ct 0st),0.264,
SS Dighe (IND),2001-2001,6,11,14,12,2,12,0,3 (3ct 0st),1.272,
RA Duff (AUS),1902-1905,22,41,14,14,0,0,14,2 (2ct 0st),0.341,
SA Durani (IND),1960-1973,29,53,14,14,0,0,14,3 (3ct 0st),0.264,
BA Edgar (NZ),1978-1986,39,72,14,14,0,4,10,3 (3ct 0st),0.194,
MTG Elliott (AUS),1996-2004,21,42,14,14,0,0,14,1 (1ct 0st),0.333,
PGH Fender (ENG),1921-1929,13,23,14,14,0,0,14,2 (2ct 0st),0.608,
BOP Fernando (SL),2019-2023,21,39,14,14,0,0,14,2 (2ct 0st),0.358,
TR Gripper (ZIM),1999-2004,20,32,14,14,0,0,14,2 (2ct 0st),0.437,
SP Gupte (IND),1951-1961,36,61,14,14,0,0,14,2 (2ct 0st),0.229,
Haris Sohail (PAK),2017-2021,16,28,14,14,0,0,14,2 (2ct 0st),0.500,
CZ Harris (NZ),1992-2002,23,38,14,14,0,0,14,3 (3ct 0st),0.368,
GA Headley (WI),1930-1954,22,38,14,14,0,0,14,2 (2ct 0st),0.368,
CJ Jordan (ENG),2014-2015,8,16,14,14,0,0,14,3 (3ct 0st),0.875,
BD Julien (WI),1973-1977,24,46,14,14,0,0,14,2 (2ct 0st),0.304,
M Kaif (IND),2000-2006,13,24,14,14,0,0,14,4 (4ct 0st),0.583,
BR Knight (ENG),1961-1969,29,55,14,14,0,0,14,2 (2ct 0st),0.254,
BW Luckhurst (ENG),1970-1974,21,39,14,14,0,0,14,2 (2ct 0st),0.358,
CL McCool (AUS),1946-1950,14,27,14,14,0,0,14,1 (1ct 0st),0.518,
CC McDonald (AUS),1952-1961,47,90,14,14,0,0,14,2 (2ct 0st),0.155,
AA Mailey (AUS),1920-1926,21,38,14,14,0,0,14,2 (2ct 0st),0.368,
CS Martin (NZ),2000-2013,71,128,14,14,0,0,14,1 (1ct 0st),0.109,
DK Morrison (NZ),1987-1997,48,76,14,14,0,0,14,2 (2ct 0st),0.184,
R Pilling (ENG),1881-1888,8,14,14,10,4,10,0,3 (1ct 2st),1.000,
AE Relf (ENG),1903-1914,13,25,14,14,0,0,14,2 (2ct 0st),0.560,
GM Ritchie (AUS),1982-1987,30,48,14,14,0,0,14,2 (2ct 0st),0.291,
EAB Rowan (SA),1935-1951,26,43,14,14,0,0,14,2 (2ct 0st),0.325,
Shubman Gill (IND),2020-2023,18,36,14,14,0,0,14,2 (2ct 0st),0.388,
CB van Ryneveld (SA),1951-1958,19,35,14,14,0,0,14,2 (2ct 0st),0.400,
SM Warnapura (SL),2007-2009,14,26,14,14,0,0,14,2 (2ct 0st),0.538,
C White (ENG),1994-2002,30,53,14,14,0,0,14,3 (3ct 0st),0.264,
NWD Yardley (ENG),1938-1950,20,36,14,14,0,0,14,2 (2ct 0st),0.388,
R Abel (ENG),1888-1902,13,26,13,13,0,0,13,3 (3ct 0st),0.500,
L Amarnath (IND),1933-1952,24,38,13,13,0,5,8,3 (3ct 0st),0.342,
J Arun Lal (IND),1982-1989,16,30,13,13,0,0,13,2 (2ct 0st),0.433,
CWJ Athey (ENG),1980-1988,23,38,13,13,0,0,13,2 (2ct 0st),0.342,
DL Bairstow (ENG),1979-1981,4,7,13,12,1,12,0,4 (4ct 0st),1.857,
AB Barath (WI),2009-2012,15,27,13,13,0,0,13,3 (3ct 0st),0.481,
KS Bharat (IND),2023-2023,5,10,13,12,1,12,0,3 (3ct 0st),1.300,
AM Blignaut (ZIM),2001-2005,19,31,13,13,0,0,13,3 (3ct 0st),0.419,
RJ Bright (AUS),1977-1986,25,42,13,13,0,0,13,1 (1ct 0st),0.309,
HD Bromfield (SA),1961-1965,9,18,13,13,0,0,13,2 (2ct 0st),0.722,
MC Carew (WI),1963-1972,19,35,13,13,0,0,13,3 (3ct 0st),0.371,
JE Cheetham (SA),1949-1955,24,43,13,13,0,0,13,3 (3ct 0st),0.302,
HL Collins (AUS),1920-1926,19,35,13,13,0,0,13,2 (2ct 0st),0.371,
JN Crawford (ENG),1906-1908,12,23,13,13,0,0,13,3 (3ct 0st),0.565,
D Dasgupta (IND),2001-2002,8,15,13,13,0,13,0,3 (3ct 0st),0.866,
BM Duckett (ENG),2016-2023,15,30,13,13,0,0,13,2 (2ct 0st),0.433,
Fawad Alam (PAK),2009-2022,19,34,13,13,0,0,13,2 (2ct 0st),0.382,
JHW Fingleton (AUS),1932-1938,18,33,13,13,0,0,13,2 (2ct 0st),0.393,
RE Foster (ENG),1903-1907,8,16,13,13,0,0,13,2 (2ct 0st),0.812,
G Geary (ENG),1924-1934,14,24,13,13,0,0,13,2 (2ct 0st),0.541,
HM Goonatilleke (SL),1982-1982,5,9,13,10,3,10,0,4 (3ct 1st),1.444,
D Gough (ENG),1994-2003,58,99,13,13,0,0,13,2 (2ct 0st),0.131,
RS Grant (WI),1935-1939,7,14,13,13,0,0,13,3 (3ct 0st),0.928,
RJ Harris (AUS),2010-2015,27,52,13,13,0,0,13,2 (2ct 0st),0.250,
JW Hearne (ENG),1911-1926,24,42,13,13,0,0,13,2 (2ct 0st),0.309,
AMJ Hilditch (AUS),1979-1985,18,28,13,13,0,0,13,2 (2ct 0st),0.464,
AS Joseph (WI),2016-2023,30,56,13,13,0,0,13,2 (2ct 0st),0.232,
AF Kippax (AUS),1925-1934,22,43,13,13,0,0,13,1 (1ct 0st),0.302,
M Leyland (ENG),1928-1938,41,75,13,13,0,0,13,2 (2ct 0st),0.173,
AR MacGibbon (NZ),1951-1958,26,38,13,13,0,0,13,2 (2ct 0st),0.342,
DJ Malan (ENG),2017-2022,22,40,13,13,0,0,13,2 (2ct 0st),0.325,
Maqsood Ahmed (PAK),1952-1955,16,27,13,13,0,0,13,2 (2ct 0st),0.481,
DPB Morkel (SA),1927-1932,16,28,13,13,0,0,13,2 (2ct 0st),0.464,
DJ Nash (NZ),1992-2001,32,56,13,13,0,0,13,2 (2ct 0st),0.232,
GE Palmer (AUS),1880-1886,17,30,13,13,0,0,13,2 (2ct 0st),0.433,
JS Patel (NZ),2006-2017,24,43,13,13,0,0,13,3 (3ct 0st),0.302,
KS Ranjitsinhji (ENG),1896-1902,15,26,13,13,0,0,13,2 (2ct 0st),0.500,
A Ratra (IND),2002-2002,6,11,13,11,2,11,0,3 (2ct 1st),1.181,
GJ Rennie (ZIM),1997-2002,23,37,13,13,0,0,13,1 (1ct 0st),0.351,
Saeed Ahmed (PAK),1958-1973,41,70,13,13,0,0,13,2 (2ct 0st),0.185,
CS Serjeant (AUS),1977-1978,12,22,13,13,0,0,13,3 (3ct 0st),0.590,
JS Solomon (WI),1958-1965,27,53,13,13,0,0,13,2 (2ct 0st),0.245,
AL Valentine (WI),1950-1962,36,70,13,13,0,0,13,1 (1ct 0st),0.185,
DJ Vilas (SA),2015-2016,6,10,13,13,0,13,0,4 (4ct 0st),1.300,
DF Whatmore (AUS),1979-1979,7,11,13,13,0,0,13,4 (4ct 0st),1.181,
SC Williams (ZIM),2013-2021,14,26,13,13,0,0,13,2 (2ct 0st),0.500,
J Worrall (AUS),1885-1899,11,19,13,13,0,0,13,3 (3ct 0st),0.684,
Abdullah Shafique (PAK),2021-2023,14,27,12,12,0,0,12,2 (2ct 0st),0.444,
Afsar Zazai (AFG),2018-2023,6,11,12,11,1,11,0,2 (2ct 0st),1.090,
TJE Andrews (AUS),1921-1926,16,28,12,12,0,0,12,2 (2ct 0st),0.428,
W Bardsley (AUS),1909-1926,41,74,12,12,0,0,12,1 (1ct 0st),0.162,
SF Barnes (ENG),1901-1914,27,52,12,12,0,0,12,2 (2ct 0st),0.230,
WKM Benjamin (WI),1987-1995,21,38,12,12,0,0,12,2 (2ct 0st),0.315,
MG Bracewell (NZ),2022-2023,8,16,12,12,0,0,12,2 (2ct 0st),0.750,
J Briggs (ENG),1884-1899,33,63,12,12,0,0,12,2 (2ct 0st),0.190,
SSJ Brooks (WI),2019-2022,13,24,12,12,0,2,10,2 (2ct 0st),0.500,
G Brown (ENG),1921-1923,7,12,12,9,3,9,0,3 (1ct 2st),1.000,
W Bruce (AUS),1885-1895,14,24,12,12,0,0,12,3 (3ct 0st),0.500,
JD Campbell (WI),2019-2022,20,38,12,12,0,0,12,1 (1ct 0st),0.315,
RH Catterall (SA),1922-1931,24,41,12,12,0,0,12,3 (3ct 0st),0.292,
RK Chauhan (IND),1993-1998,21,36,12,12,0,0,12,2 (2ct 0st),0.333,
AG Cremer (ZIM),2005-2017,19,29,12,12,0,0,12,2 (2ct 0st),0.413,
TB de Bruyn (SA),2017-2022,13,22,12,12,0,0,12,4 (4ct 0st),0.545,
MH Dekker (ZIM),1993-1996,14,25,12,12,0,0,12,4 (4ct 0st),0.480,
JEC Franklin (NZ),2001-2013,31,56,12,12,0,0,12,1 (1ct 0st),0.214,
GM Fullerton (SA),1947-1951,7,13,12,10,2,6,4,4 (3ct 1st),0.923,
EA Halliwell (SA),1892-1902,8,13,12,10,2,10,0,2 (2ct 0st),0.923,
DW Hookes (AUS),1977-1985,23,42,12,12,0,0,12,2 (2ct 0st),0.285,
WP Howell (AUS),1898-1904,18,33,12,12,0,0,12,2 (2ct 0st),0.363,
SS Iyer (IND),2021-2023,10,20,12,12,0,0,12,2 (2ct 0st),0.600,
NC Johnson (ZIM),1998-2000,13,21,12,12,0,0,12,3 (3ct 0st),0.571,
SP Jones (AUS),1882-1888,12,21,12,12,0,0,12,2 (2ct 0st),0.571,
H Klaasen (SA),2019-2023,4,6,12,10,2,10,0,4 (3ct 1st),2.000,
JC Laker (ENG),1948-1959,46,91,12,12,0,0,12,1 (1ct 0st),0.131,
AV Mankad (IND),1969-1978,22,43,12,12,0,0,12,2 (2ct 0st),0.279,
RW Morgan (NZ),1965-1972,20,37,12,12,0,0,12,2 (2ct 0st),0.324,
JDS Neesham (NZ),2014-2017,12,24,12,12,0,0,12,3 (3ct 0st),0.500,
AD Nourse (SA),1935-1951,34,57,12,12,0,0,12,2 (2ct 0st),0.210,
SM Patil (IND),1980-1984,29,49,12,12,0,0,12,2 (2ct 0st),0.244,
V Rathour (IND),1996-1997,6,11,12,12,0,0,12,2 (2ct 0st),1.090,
RWV Robins (ENG),1929-1937,19,38,12,12,0,0,12,3 (3ct 0st),0.315,
JD Ryder (NZ),2008-2011,18,32,12,12,0,0,12,2 (2ct 0st),0.375,
Salman Butt (PAK),2003-2010,33,63,12,12,0,0,12,2 (2ct 0st),0.190,
S Samarawickrama (SL),2017-2023,8,14,12,10,2,6,4,2 (2ct 0st),0.857,
Rev.DS Sheppard (ENG),1950-1963,22,42,12,12,0,0,12,1 (1ct 0st),0.285,
Shoaib Akhtar (PAK),1997-2007,46,86,12,12,0,0,12,2 (2ct 0st),0.139,
DP Sibley (ENG),2019-2021,22,41,12,12,0,0,12,2 (2ct 0st),0.292,
RT Spooner (ENG),1951-1955,7,12,12,10,2,10,0,3 (2ct 1st),1.000,
PCR Tufnell (ENG),1990-2001,42,74,12,12,0,0,12,1 (1ct 0st),0.162,
Umar Akmal (PAK),2009-2011,16,31,12,12,0,0,12,2 (2ct 0st),0.387,
MRJ Veletta (AUS),1987-1990,8,14,12,12,0,0,12,2 (2ct 0st),0.857,
MHN Walker (AUS),1972-1977,34,64,12,12,0,0,12,1 (1ct 0st),0.187,
JH Wardle (ENG),1948-1957,28,56,12,12,0,0,12,3 (3ct 0st),0.214,
C Washbrook (ENG),1937-1956,37,69,12,12,0,0,12,2 (2ct 0st),0.173,
JC Watkins (SA),1949-1957,15,28,12,12,0,0,12,3 (3ct 0st),0.428,
BW Yuile (NZ),1963-1969,17,29,12,12,0,0,12,2 (2ct 0st),0.413,
DS Atkinson (WI),1948-1958,22,43,11,11,0,0,11,2 (2ct 0st),0.255,
AM Bacher (SA),1996-1999,19,35,11,11,0,0,11,2 (2ct 0st),0.314,
RMH Binny (IND),1979-1987,27,47,11,11,0,0,11,1 (1ct 0st),0.234,
JH Board (ENG),1899-1906,6,11,11,8,3,8,0,2 (2ct 0st),1.000,
DAJ Bracewell (NZ),2011-2023,28,51,11,11,0,0,11,2 (2ct 0st),0.215,
CC Depeiaza (WI),1955-1956,5,9,11,7,4,6,1,3 (1ct 2st),1.222,
PS de Villiers (SA),1993-1998,18,35,11,11,0,0,11,2 (2ct 0st),0.314,
Harry Elliott (ENG),1928-1934,4,8,11,8,3,8,0,3 (3ct 0st),1.375,
Fazal Mahmood (PAK),1952-1962,34,56,11,11,0,0,11,1 (1ct 0st),0.196,
W Ferguson (WI),1948-1954,8,16,11,11,0,0,11,3 (3ct 0st),0.687,
FR Foster (ENG),1911-1912,11,20,11,11,0,0,11,2 (2ct 0st),0.550,
Ghulam Ahmed (IND),1948-1959,22,37,11,11,0,0,11,1 (1ct 0st),0.297,
WW Hall (WI),1958-1969,48,92,11,11,0,0,11,1 (1ct 0st),0.119,
Hanumant Singh (IND),1964-1969,14,25,11,11,0,0,11,2 (2ct 0st),0.440,
RI Harford (NZ),1968-1968,3,6,11,11,0,11,0,5 (5ct 0st),1.833,
VS Hazare (IND),1946-1953,30,48,11,11,0,0,11,2 (2ct 0st),0.229,
AJY Hopkins (AUS),1902-1909,20,38,11,11,0,0,11,2 (2ct 0st),0.289,
J Hunter (ENG),1884-1885,5,10,11,8,3,8,0,4 (2ct 2st),1.100,
GL Jessop (ENG),1899-1912,18,34,11,11,0,0,11,2 (2ct 0st),0.323,
Junaid Siddique (BAN),2008-2012,19,33,11,11,0,0,11,2 (2ct 0st),0.333,
RWT Key (ENG),2002-2005,15,27,11,11,0,0,11,2 (2ct 0st),0.407,
DS Lehmann (AUS),1998-2004,27,54,11,11,0,0,11,1 (1ct 0st),0.203,
JK Lever (ENG),1976-1986,21,38,11,11,0,0,11,1 (1ct 0st),0.289,
P Lever (ENG),1970-1975,17,31,11,11,0,0,11,2 (2ct 0st),0.354,
D Lloyd (ENG),1974-1975,9,18,11,11,0,0,11,3 (3ct 0st),0.611,
EJG Morgan (ENG),2010-2012,16,32,11,11,0,0,11,2 (2ct 0st),0.343,
BA Murphy (ZIM),2000-2001,11,20,11,11,0,0,11,1 (1ct 0st),0.550,
Nasim-ul-Ghani (PAK),1958-1973,29,49,11,11,0,0,11,2 (2ct 0st),0.224,
MS Nichols (ENG),1930-1939,14,24,11,11,0,0,11,2 (2ct 0st),0.458,
MHW Papps (NZ),2004-2007,8,14,11,11,0,0,11,2 (2ct 0st),0.785,
H Philipson (ENG),1892-1895,5,9,11,8,3,8,0,3 (1ct 2st),1.222,
B Reddy (IND),1979-1979,4,5,11,9,2,9,0,3 (3ct 0st),2.200,
Rubel Hossain (BAN),2009-2020,27,47,11,11,0,0,11,1 (1ct 0st),0.234,
HD Rutherford (NZ),2013-2015,16,31,11,11,0,0,11,3 (3ct 0st),0.354,
Saeed Ajmal (PAK),2009-2014,35,67,11,11,0,0,11,2 (2ct 0st),0.164,
Saleem Elahi (PAK),1995-2003,13,23,11,10,1,0,10,4 (4ct 0st),0.478,
Shadab Kabir (PAK),1996-2002,5,9,11,11,0,0,11,3 (3ct 0st),1.222,
IS Sodhi (NZ),2013-2023,19,37,11,11,0,0,11,2 (2ct 0st),0.297,
FR Spofforth (AUS),1877-1887,18,31,11,11,0,0,11,3 (3ct 0st),0.354,
W Storer (ENG),1897-1899,6,10,11,11,0,11,0,3 (3ct 0st),1.100,
BC Strang (ZIM),1995-2001,26,46,11,11,0,0,11,1 (1ct 0st),0.239,
MW Tate (ENG),1924-1935,39,68,11,11,0,0,11,2 (2ct 0st),0.161,
JM Taylor (AUS),1920-1926,20,37,11,11,0,0,11,1 (1ct 0st),0.297,
Umar Gul (PAK),2003-2013,47,91,11,11,0,0,11,2 (2ct 0st),0.120,
PL van der Merwe (SA),1963-1967,15,30,11,11,0,0,11,2 (2ct 0st),0.366,
M van Jaarsveld (SA),2002-2004,9,17,11,11,0,0,11,2 (2ct 0st),0.647,
S Viswanath (IND),1985-1985,3,6,11,11,0,11,0,4 (4ct 0st),1.833,
TW Wall (AUS),1929-1934,18,34,11,11,0,0,11,2 (2ct 0st),0.323,
PJ Wiseman (NZ),1998-2005,25,48,11,11,0,0,11,2 (2ct 0st),0.229,
A Wood (ENG),1938-1939,4,7,11,10,1,10,0,2 (2ct 0st),1.571,
Yajurvindra Singh (IND),1977-1979,4,8,11,11,0,0,11,5 (5ct 0st),1.375,
DA Allen (ENG),1960-1966,39,69,10,10,0,0,10,2 (2ct 0st),0.144,
Al Sahariar (BAN),2000-2003,15,20,10,10,0,0,10,3 (3ct 0st),0.500,
Asim Kamal (PAK),2003-2005,12,23,10,10,0,0,10,2 (2ct 0st),0.434,
A Bacher (SA),1965-1970,12,24,10,10,0,0,10,2 (2ct 0st),0.416,
GJ Bailey (AUS),2013-2014,5,10,10,10,0,0,10,2 (2ct 0st),1.000,
KC Bland (SA),1961-1966,21,40,10,10,0,0,10,2 (2ct 0st),0.250,
HF Boyle (AUS),1879-1884,12,23,10,10,0,0,10,1 (1ct 0st),0.434,
BC Broad (ENG),1984-1989,25,41,10,10,0,0,10,2 (2ct 0st),0.243,
ME Chapple (NZ),1953-1966,14,26,10,10,0,0,10,2 (2ct 0st),0.384,
RO Collinge (NZ),1965-1978,35,63,10,10,0,0,10,1 (1ct 0st),0.158,
RDB Croft (ENG),1996-2001,21,35,10,10,0,0,10,2 (2ct 0st),0.285,
WW Davis (WI),1983-1988,15,28,10,10,0,0,10,2 (2ct 0st),0.357,
OC Dawson (SA),1947-1949,9,17,10,10,0,0,10,3 (3ct 0st),0.588,
GR Dilley (ENG),1979-1989,41,66,10,10,0,0,10,2 (2ct 0st),0.151,
DR Doshi (IND),1979-1983,33,57,10,10,0,0,10,2 (2ct 0st),0.175,
KS Duleepsinhji (ENG),1929-1931,12,17,10,10,0,0,10,2 (2ct 0st),0.588,
J Dyson (AUS),1977-1984,30,56,10,10,0,0,10,2 (2ct 0st),0.178,
FH Edwards (WI),2003-2012,55,102,10,10,0,0,10,1 (1ct 0st),0.098,
CRD Fernando (SL),2000-2012,40,69,10,10,0,0,10,2 (2ct 0st),0.144,
DR Flynn (NZ),2008-2013,24,40,10,10,0,0,10,2 (2ct 0st),0.250,
G Fowler (ENG),1982-1985,21,39,10,10,0,0,10,1 (1ct 0st),0.256,
MW Goodwin (ZIM),1998-2000,19,32,10,10,0,0,10,3 (3ct 0st),0.312,
GC Grant (WI),1930-1935,12,18,10,10,0,0,10,2 (2ct 0st),0.555,
RE Grieveson (SA),1939-1939,2,4,10,7,3,7,0,3 (3ct 0st),2.500,
HSTL Hendry (AUS),1921-1929,11,22,10,10,0,0,10,3 (3ct 0st),0.454,
Ibrahim Zadran (AFG),2019-2023,5,10,10,10,0,0,10,2 (2ct 0st),1.000,
Hon.FS Jackson (ENG),1893-1905,20,36,10,10,0,0,10,2 (2ct 0st),0.277,
Javed Omar (BAN),2001-2007,40,54,10,10,0,0,10,2 (2ct 0st),0.185,
DRE Joseph (WI),1999-1999,4,8,10,10,0,0,10,3 (3ct 0st),1.250,
RS Kalpage (SL),1993-1999,11,16,10,10,0,0,10,2 (2ct 0st),0.625,
GF Lawson (AUS),1980-1989,46,81,10,10,0,0,10,2 (2ct 0st),0.123,
PA McAlister (AUS),1904-1909,8,16,10,10,0,0,10,2 (2ct 0st),0.625,
TG McIntosh (NZ),2008-2011,17,32,10,10,0,0,10,2 (2ct 0st),0.312,
CA McWatt (WI),1954-1955,6,11,10,9,1,9,0,3 (3ct 0st),0.909,
KR Mayers (WI),2021-2023,18,35,10,10,0,0,10,2 (2ct 0st),0.285,
IL Mendonca (WI),1962-1962,2,4,10,8,2,8,0,3 (2ct 1st),2.500,
WE Midwinter (AUS/ENG),1877-1887,12,22,10,10,0,0,10,2 (2ct 0st),0.454,
Mohammed Siraj (IND),2020-2023,21,41,10,10,0,0,10,2 (2ct 0st),0.243,
PJ Moor (IRE/ZIM),2016-2023,12,20,10,9,1,6,3,3 (2ct 1st),0.500,
MD Moxon (ENG),1986-1989,10,16,10,10,0,0,10,3 (3ct 0st),0.625,
Nasir Hossain (BAN),2011-2017,19,33,10,10,0,0,10,2 (2ct 0st),0.303,
PP Ojha (IND),2009-2013,24,48,10,10,0,0,10,1 (1ct 0st),0.208,
HK Olonga (ZIM),1995-2002,30,51,10,10,0,0,10,2 (2ct 0st),0.196,
MS Panesar (ENG),2006-2013,50,90,10,10,0,0,10,1 (1ct 0st),0.111,
DR Pringle (ENG),1982-1992,30,56,10,10,0,0,10,2 (2ct 0st),0.178,
KR Pushpakumara (SL),1994-2001,23,39,10,10,0,0,10,3 (3ct 0st),0.256,
AF Rae (WI),1948-1953,15,30,10,10,0,0,10,2 (2ct 0st),0.333,
VS Ransford (AUS),1907-1912,20,39,10,10,0,0,10,2 (2ct 0st),0.256,
Shadman Islam (BAN),2018-2022,13,20,10,10,0,0,10,4 (4ct 0st),0.500,
Shahid Afridi (PAK),1998-2010,27,52,10,10,0,0,10,2 (2ct 0st),0.192,
BR Taylor (NZ),1965-1973,30,55,10,10,0,0,10,1 (1ct 0st),0.181,
PL Taylor (AUS),1987-1991,13,23,10,10,0,0,10,2 (2ct 0st),0.434,
EFS Tylecote (ENG),1882-1886,6,12,10,5,5,5,0,3 (1ct 2st),0.833,
KDK Vithanage (SL),2013-2015,10,20,10,10,0,0,10,2 (2ct 0st),0.500,
MN Waller (ZIM),2011-2017,14,25,10,10,0,0,10,2 (2ct 0st),0.400,
CAK Walton (WI),2009-2009,2,4,10,10,0,10,0,5 (5ct 0st),2.500,
Waqar Hasan (PAK),1952-1959,21,36,10,10,0,0,10,2 (2ct 0st),0.277,
S Wettimuny (SL),1982-1987,23,35,10,10,0,0,10,2 (2ct 0st),0.285,
GC White (SA),1906-1912,17,31,10,10,0,0,10,2 (2ct 0st),0.322,
AGD Wickremasinghe (SL),1989-1992,3,6,10,9,1,9,0,3 (3ct 0st),1.666,
RA Woolmer (ENG),1975-1981,19,36,10,10,0,0,10,2 (2ct 0st),0.277,
DVP Wright (ENG),1938-1951,34,62,10,10,0,0,10,2 (2ct 0st),0.161,
NS Yadav (IND),1979-1987,35,64,10,10,0,0,10,1 (1ct 0st),0.156,
Zulqarnain (PAK),1986-1986,3,6,10,8,2,8,0,3 (3ct 0st),1.666,
PK Amre (IND),1992-1993,11,21,9,9,0,0,9,2 (2ct 0st),0.428,
GG Arnold (ENG),1967-1975,34,61,9,9,0,0,9,2 (2ct 0st),0.147,
W Attewell (ENG),1884-1892,10,20,9,9,0,0,9,2 (2ct 0st),0.450,
W Bates (ENG),1881-1887,15,29,9,9,0,0,9,1 (1ct 0st),0.310,
JM Blanckenberg (SA),1913-1924,18,29,9,9,0,0,9,2 (2ct 0st),0.310,
BJT Bosanquet (ENG),1903-1905,7,13,9,9,0,0,9,2 (2ct 0st),0.692,
HC Brook (ENG),2022-2023,12,24,9,9,0,0,9,2 (2ct 0st),0.375,
G Cook (ENG),1982-1983,7,13,9,9,0,0,9,2 (2ct 0st),0.692,
NG Cowans (ENG),1982-1985,19,36,9,9,0,0,9,1 (1ct 0st),0.250,
IC Davis (AUS),1973-1977,15,28,9,9,0,0,9,2 (2ct 0st),0.321,
ALF de Mel (SL),1982-1986,17,27,9,9,0,0,9,2 (2ct 0st),0.333,
RB Desai (IND),1959-1968,28,45,9,9,0,0,9,2 (2ct 0st),0.200,
JWHT Douglas (ENG),1911-1925,23,42,9,9,0,0,9,3 (3ct 0st),0.214,
T Emmett (ENG),1877-1882,7,13,9,9,0,0,9,3 (3ct 0st),0.692,
LE Favell (AUS),1954-1961,19,37,9,9,0,0,9,2 (2ct 0st),0.243,
DW Fleming (AUS),1994-2001,20,38,9,9,0,0,9,2 (2ct 0st),0.236,
ARC Fraser (ENG),1989-1998,46,80,9,9,0,0,9,2 (2ct 0st),0.112,
JH Hampshire (ENG),1969-1975,8,16,9,9,0,0,9,2 (2ct 0st),0.562,
J Hardstaff jnr (ENG),1935-1948,23,44,9,9,0,0,9,1 (1ct 0st),0.204,
MN Hart (NZ),1994-1995,14,22,9,9,0,0,9,1 (1ct 0st),0.409,
NJN Hawke (AUS),1963-1968,27,50,9,9,0,0,9,1 (1ct 0st),0.180,
BJ Hodge (AUS),2005-2008,6,12,9,9,0,0,9,2 (2ct 0st),0.750,
RIC Holder (WI),1997-1999,11,19,9,9,0,0,9,2 (2ct 0st),0.473,
GJ Hopkins (NZ),2008-2010,4,6,9,9,0,9,0,3 (3ct 0st),1.500,
KL Hutchings (ENG),1907-1909,7,14,9,9,0,0,9,2 (2ct 0st),0.642,
RA Hutton (ENG),1971-1971,5,9,9,9,0,0,9,2 (2ct 0st),1.000,
KS Indrajitsinhji (IND),1964-1969,4,8,9,6,3,6,0,2 (2ct 0st),1.125,
M Jansen (SA),2021-2023,11,19,9,9,0,0,9,3 (3ct 0st),0.473,
HJ Keith (SA),1953-1957,8,16,9,9,0,0,9,2 (2ct 0st),0.562,
LF Kline (AUS),1957-1961,13,25,9,9,0,0,9,2 (2ct 0st),0.360,
RA Legall (WI),1953-1953,4,8,9,8,1,8,0,3 (3ct 0st),1.125,
SN McGregor (NZ),1955-1965,25,39,9,9,0,0,9,1 (1ct 0st),0.230,
CE McLeod (AUS),1894-1905,17,31,9,9,0,0,9,1 (1ct 0st),0.290,
RS Madugalle (SL),1982-1988,21,34,9,9,0,0,9,2 (2ct 0st),0.264,
Maninder Singh (IND),1982-1993,35,57,9,9,0,0,9,1 (1ct 0st),0.157,
Mansoor Akhtar (PAK),1980-1990,19,34,9,9,0,0,9,1 (1ct 0st),0.264,
MK Mantri (IND),1951-1955,4,8,9,8,1,6,2,4 (3ct 1st),1.125,
Mashrafe Mortaza (BAN),2001-2009,36,52,9,9,0,0,9,1 (1ct 0st),0.173,
I Meckiff (AUS),1957-1963,18,36,9,9,0,0,9,2 (2ct 0st),0.250,
LRD Mendis (SL),1982-1988,24,37,9,9,0,0,9,1 (1ct 0st),0.243,
A Mitchell (ENG),1933-1936,6,12,9,9,0,0,9,2 (2ct 0st),0.750,
TM Moody (AUS),1989-1992,8,13,9,9,0,0,9,2 (2ct 0st),0.692,
JFM Morrison (NZ),1973-1982,17,29,9,9,0,0,9,2 (2ct 0st),0.310,
RC Motz (NZ),1961-1969,32,58,9,9,0,0,9,1 (1ct 0st),0.155,
Naushad Ali (PAK),1965-1965,6,11,9,9,0,9,0,3 (3ct 0st),0.818,
EP Nupen (SA),1921-1936,17,32,9,9,0,0,9,2 (2ct 0st),0.281,
Pervez Sajjad (PAK),1964-1973,19,37,9,9,0,0,9,1 (1ct 0st),0.243,
RJ Peterson (SA),2003-2014,15,29,9,9,0,0,9,2 (2ct 0st),0.310,
PM Pollock (SA),1961-1970,28,54,9,9,0,0,9,2 (2ct 0st),0.166,
Rahat Ali (PAK),2013-2018,21,40,9,9,0,0,9,1 (1ct 0st),0.225,
S Ramadhin (WI),1950-1961,43,82,9,9,0,0,9,2 (2ct 0st),0.109,
Raqibul Hasan (BAN),2008-2011,9,17,9,9,0,0,9,2 (2ct 0st),0.529,
RJ Ratnayake (SL),1983-1992,23,36,9,9,0,0,9,1 (1ct 0st),0.250,
JF Reid (NZ),1979-1986,19,35,9,9,0,0,9,3 (3ct 0st),0.257,
MT Renshaw (AUS),2016-2023,14,26,9,9,0,0,9,1 (1ct 0st),0.346,
AME Roberts (WI),1974-1983,47,90,9,9,0,0,9,1 (1ct 0st),0.100,
Shahadat Hossain (BAN),2005-2015,38,63,9,9,0,0,9,1 (1ct 0st),0.142,
S Shillingford (WI),2010-2014,16,29,9,9,0,0,9,1 (1ct 0st),0.310,
NS Sidhu (IND),1983-1999,51,90,9,9,0,0,9,2 (2ct 0st),0.100,
JH Sinclair (SA),1896-1911,25,46,9,9,0,0,9,1 (1ct 0st),0.195,
L Sivaramakrishnan (IND),1983-1986,9,16,9,9,0,0,9,2 (2ct 0st),0.562,
GC Small (ENG),1986-1991,17,32,9,9,0,0,9,2 (2ct 0st),0.281,
DR Smith (WI),2004-2006,10,18,9,9,0,0,9,3 (3ct 0st),0.500,
OG Smith (WI),1955-1959,26,46,9,9,0,0,9,2 (2ct 0st),0.195,
RT Stanyforth (ENG),1927-1928,4,8,9,7,2,7,0,3 (3ct 0st),1.125,
GTS Stevens (ENG),1922-1930,10,19,9,9,0,0,9,2 (2ct 0st),0.473,
V Subramanya (IND),1965-1968,9,15,9,9,0,0,9,3 (3ct 0st),0.600,
Taslim Arif (PAK),1980-1980,6,10,9,6,3,6,0,2 (1ct 1st),0.900,
Tauseef Ahmed (PAK),1980-1993,34,62,9,9,0,0,9,2 (2ct 0st),0.145,
PM Toohey (AUS),1977-1980,15,28,9,9,0,0,9,2 (2ct 0st),0.321,
L Tuckett (SA),1947-1949,9,17,9,9,0,0,9,2 (2ct 0st),0.529,
PA Wallace (WI),1997-1999,7,13,9,9,0,0,9,2 (2ct 0st),0.692,
Abdur Rehman (PAK),2007-2014,22,44,8,8,0,0,8,1 (1ct 0st),0.181,
HR Adhikari (IND),1947-1959,21,30,8,8,0,0,8,2 (2ct 0st),0.266,
Akram Raza (PAK),1989-1995,9,15,8,8,0,0,8,2 (2ct 0st),0.533,
Alimuddin (PAK),1954-1962,25,43,8,8,0,0,8,2 (2ct 0st),0.186,
EG Arnold (ENG),1903-1907,10,19,8,8,0,0,8,2 (2ct 0st),0.421,
GA Bartlett (NZ),1961-1968,10,18,8,8,0,0,8,1 (1ct 0st),0.444,
CA Best (WI),1986-1990,8,16,8,8,0,0,8,2 (2ct 0st),0.500,
MG Bevan (AUS),1994-1998,18,36,8,8,0,0,8,2 (2ct 0st),0.222,
SW Billings (ENG),2022-2022,3,6,8,8,0,8,0,5 (5ct 0st),1.333,
JG Binks (ENG),1964-1964,2,4,8,8,0,8,0,5 (5ct 0st),2.000,
IR Bishop (WI),1989-1998,43,79,8,8,0,0,8,2 (2ct 0st),0.101,
SE Bond (NZ),2001-2009,18,32,8,8,0,0,8,1 (1ct 0st),0.250,
TT Bresnan (ENG),2009-2013,23,43,8,8,0,0,8,1 (1ct 0st),0.186,
JJ Bumrah (IND),2018-2022,30,59,8,8,0,0,8,1 (1ct 0st),0.135,
T Campbell (SA),1910-1912,5,9,8,7,1,7,0,2 (2ct 0st),0.888,
HB Cave (NZ),1949-1958,19,27,8,8,0,0,8,2 (2ct 0st),0.296,
BB Chari (ZIM),2014-2018,7,13,8,8,0,3,5,3 (3ct 0st),0.615,
WL Cornford (ENG),1930-1930,4,6,8,5,3,5,0,3 (2ct 1st),1.333,
A Cotter (AUS),1904-1912,21,40,8,8,0,0,8,2 (2ct 0st),0.200,
CEH Croft (WI),1977-1982,27,52,8,8,0,0,8,2 (2ct 0st),0.153,
LS Darling (AUS),1933-1937,12,23,8,8,0,0,8,3 (3ct 0st),0.347,
HG Deane (SA),1924-1931,17,27,8,8,0,0,8,2 (2ct 0st),0.296,
D Denton (ENG),1905-1910,11,21,8,8,0,0,8,2 (2ct 0st),0.380,
SJ Erwee (SA),2022-2023,10,16,8,8,0,0,8,2 (2ct 0st),0.500,
ST Finn (ENG),2010-2016,36,68,8,8,0,0,8,2 (2ct 0st),0.117,
TJ Franklin (NZ),1983-1991,21,35,8,8,0,0,8,2 (2ct 0st),0.228,
N Gifford (ENG),1964-1973,15,27,8,8,0,0,8,1 (1ct 0st),0.296,
GJ Gilmour (AUS),1973-1977,15,29,8,8,0,0,8,2 (2ct 0st),0.275,
DR Hadlee (NZ),1969-1978,26,45,8,8,0,0,8,2 (2ct 0st),0.177,
S Haigh (ENG),1899-1912,11,19,8,8,0,0,8,2 (2ct 0st),0.421,
AD Hales (ENG),2015-2016,11,21,8,8,0,0,8,2 (2ct 0st),0.380,
MS Harris (AUS),2018-2022,14,27,8,8,0,0,8,2 (2ct 0st),0.296,
WK Hegg (ENG),1998-1999,2,4,8,8,0,8,0,3 (3ct 0st),2.000,
PS Heine (SA),1955-1962,14,28,8,8,0,0,8,2 (2ct 0st),0.285,
MJ Henry (NZ),2015-2023,21,41,8,8,0,0,8,2 (2ct 0st),0.195,
RNS Hobbs (ENG),1967-1971,7,12,8,8,0,0,8,2 (2ct 0st),0.666,
JKC Holt (WI),1954-1959,17,32,8,8,0,0,8,2 (2ct 0st),0.250,
Imran Tahir (SA),2011-2015,20,38,8,8,0,0,8,1 (1ct 0st),0.210,
DJ Insole (ENG),1950-1957,9,18,8,8,0,0,8,3 (3ct 0st),0.444,
Khurram Manzoor (PAK),2009-2014,16,30,8,8,0,0,8,2 (2ct 0st),0.266,
PN Kirsten (SA),1992-1994,12,23,8,8,0,0,8,3 (3ct 0st),0.347,
P Krishnamurthy (IND),1971-1971,5,10,8,7,1,7,0,2 (2ct 0st),0.800,
KMDN Kulasekara (SL),2005-2014,21,40,8,8,0,0,8,2 (2ct 0st),0.200,
B Kumar (IND),2013-2018,21,38,8,8,0,0,8,2 (2ct 0st),0.210,
CB Lambert (WI),1991-1998,5,10,8,8,0,0,8,3 (3ct 0st),0.800,
ACB Langton (SA),1935-1939,15,23,8,8,0,0,8,1 (1ct 0st),0.347,
W Larkins (ENG),1980-1991,13,22,8,8,0,0,8,2 (2ct 0st),0.363,
FJ Laver (AUS),1899-1909,15,28,8,8,0,0,8,1 (1ct 0st),0.285,
DM Lewis (WI),1971-1971,3,6,8,8,0,8,0,4 (4ct 0st),1.333,
TC Lowry (NZ),1930-1931,7,11,8,8,0,0,8,2 (2ct 0st),0.727,
A Lyth (ENG),2015-2015,7,13,8,8,0,0,8,2 (2ct 0st),0.615,
EL McCormick (AUS),1935-1938,12,22,8,8,0,0,8,2 (2ct 0st),0.363,
AJW McIntyre (ENG),1950-1955,3,5,8,8,0,7,1,3 (3ct 0st),1.600,
TG McMahon (NZ),1955-1956,5,6,8,7,1,7,0,3 (2ct 1st),1.333,
Q McMillan (SA),1929-1932,13,23,8,8,0,0,8,2 (2ct 0st),0.347,
A Melville (SA),1938-1949,11,20,8,8,0,0,8,2 (2ct 0st),0.400,
BD Milburn (NZ),1969-1969,3,5,8,6,2,6,0,3 (3ct 0st),1.600,
A Mishra (IND),2008-2016,22,40,8,8,0,0,8,1 (1ct 0st),0.200,
MV Narasimha Rao (IND),1978-1979,4,8,8,8,0,0,8,2 (2ct 0st),1.000,
IK Pathan (IND),2003-2008,29,54,8,8,0,0,8,1 (1ct 0st),0.148,
DBL Powell (WI),2002-2009,37,68,8,8,0,0,8,2 (2ct 0st),0.117,
D Ramnarine (WI),1998-2002,12,24,8,8,0,0,8,2 (2ct 0st),0.333,
JM Read (ENG),1882-1893,17,33,8,8,0,0,8,1 (1ct 0st),0.242,
OE Robinson (ENG),2021-2023,19,37,8,8,0,0,8,1 (1ct 0st),0.216,
RT Robinson (ENG),1984-1989,29,49,8,8,0,0,8,1 (1ct 0st),0.163,
CAG Russell (ENG),1920-1923,10,16,8,8,0,0,8,3 (3ct 0st),0.500,
RG Samuels (WI),1996-1997,6,12,8,8,0,0,8,2 (2ct 0st),0.666,
Saud Shakeel (PAK),2022-2023,7,14,8,8,0,0,8,2 (2ct 0st),0.571,
HJH Scott (AUS),1884-1886,8,13,8,8,0,0,8,2 (2ct 0st),0.615,
Shujauddin (PAK),1954-1962,19,34,8,8,0,0,8,1 (1ct 0st),0.235,
Shuvagata Hom (BAN),2014-2016,8,14,8,8,0,0,8,2 (2ct 0st),0.571,
BW Sinclair (NZ),1963-1968,21,37,8,8,0,0,8,2 (2ct 0st),0.216,
GB Studd (ENG),1882-1883,4,8,8,8,0,0,8,3 (3ct 0st),1.000,
ML Su'a (NZ),1992-1995,13,22,8,8,0,0,8,2 (2ct 0st),0.363,
R Tattersall (ENG),1951-1954,16,30,8,8,0,0,8,2 (2ct 0st),0.266,
JE Taylor (WI),2003-2016,46,81,8,8,0,0,8,1 (1ct 0st),0.098,
AJ Traicos (SA/ZIM),1970-1993,7,12,8,8,0,0,8,4 (4ct 0st),0.666,
CTB Turner (AUS),1887-1895,17,30,8,8,0,0,8,2 (2ct 0st),0.266,
JM Vince (ENG),2016-2018,13,24,8,8,0,0,8,2 (2ct 0st),0.333,
W Watson (ENG),1951-1959,23,44,8,8,0,0,8,1 (1ct 0st),0.181,
AR Whittall (ZIM),1996-1999,10,16,8,8,0,0,8,3 (3ct 0st),0.500,
MA Wood (ENG),2015-2023,31,60,8,8,0,0,8,1 (1ct 0st),0.133,
TS Worthington (ENG),1930-1937,9,15,8,8,0,0,8,1 (1ct 0st),0.533,
RA Young (NZ),2011-2011,5,10,8,8,0,8,0,2 (2ct 0st),0.800,
Aftab Ahmed (BAN),2004-2010,16,23,7,7,0,0,7,2 (2ct 0st),0.304,
Agha Salman (PAK),2022-2023,9,18,7,7,0,0,7,1 (1ct 0st),0.388,
JC Alabaster (NZ),1955-1972,21,35,7,7,0,0,7,1 (1ct 0st),0.200,
Inshan Ali (WI),1971-1977,12,23,7,7,0,0,7,2 (2ct 0st),0.304,
CJ Anderson (NZ),2013-2016,13,25,7,7,0,0,7,2 (2ct 0st),0.280,
WE Astill (ENG),1927-1930,9,18,7,7,0,0,7,1 (1ct 0st),0.388,
Hon.IFW Bligh (ENG),1882-1883,4,8,7,7,0,0,7,2 (2ct 0st),0.875,
DJ Brown (ENG),1965-1969,26,46,7,7,0,0,7,2 (2ct 0st),0.152,
JT Brown (ENG),1894-1899,8,15,7,7,0,1,6,1 (1ct 0st),0.466,
MA Carberry (ENG),2010-2014,6,12,7,7,0,0,7,1 (1ct 0st),0.583,
UDU Chandana (SL),1999-2005,16,30,7,7,0,0,7,1 (1ct 0st),0.233,
EJ Chatfield (NZ),1975-1989,43,75,7,7,0,0,7,2 (2ct 0st),0.093,
CM Christiani (WI),1935-1935,4,8,7,6,1,6,0,3 (2ct 1st),0.875,
PT Collins (WI),1999-2006,32,61,7,7,0,0,7,1 (1ct 0st),0.114,
NRD Compton (ENG),2012-2016,16,29,7,7,0,0,7,2 (2ct 0st),0.241,
JF Crapp (ENG),1948-1949,7,13,7,7,0,0,7,2 (2ct 0st),0.538,
JL Denly (ENG),2019-2020,15,29,7,7,0,0,7,1 (1ct 0st),0.241,
Dilawar Hussain (IND),1934-1936,3,6,7,6,1,6,0,3 (3ct 0st),1.166,
MP Donnelly (NZ),1937-1949,7,12,7,7,0,0,7,2 (2ct 0st),0.583,
GN Edwards (NZ),1977-1981,8,13,7,7,0,7,0,3 (3ct 0st),0.538,
R Edwards (AUS),1972-1975,20,39,7,7,0,0,7,2 (2ct 0st),0.179,
SM Ervine (ZIM),2003-2004,5,6,7,7,0,0,7,2 (2ct 0st),1.166,
W Farrimond (ENG),1931-1935,4,8,7,5,2,5,0,2 (0ct 2st),0.875,
AJ Finch (AUS),2018-2018,5,10,7,7,0,0,7,4 (4ct 0st),0.700,
NA Foster (ENG),1983-1993,29,50,7,7,0,0,7,1 (1ct 0st),0.140,
GN Francis (WI),1928-1933,10,13,7,7,0,0,7,2 (2ct 0st),0.538,
KJ Funston (SA),1952-1958,18,34,7,7,0,0,7,2 (2ct 0st),0.205,
TW Garrett (AUS),1877-1888,19,34,7,7,0,0,7,1 (1ct 0st),0.205,
H Hameed (ENG),2016-2022,10,19,7,7,0,0,7,3 (3ct 0st),0.368,
Hannan Sarkar (BAN),2002-2004,17,26,7,7,0,0,7,2 (2ct 0st),0.269,
SJ Harmison (ENG/ICC),2002-2009,63,115,7,7,0,0,7,1 (1ct 0st),0.060,
UC Hathurusingha (SL),1991-1999,26,44,7,7,0,0,7,1 (1ct 0st),0.159,
FC Hayes (ENG),1973-1976,9,15,7,7,0,0,7,2 (2ct 0st),0.466,
DW Headley (ENG),1997-1999,15,25,7,7,0,0,7,1 (1ct 0st),0.280,
SO Hetmyer (WI),2017-2019,16,29,7,7,0,0,7,2 (2ct 0st),0.241,
BW Hilfenhaus (AUS),2009-2012,27,50,7,7,0,0,7,2 (2ct 0st),0.140,
RO Hinds (WI),2002-2009,15,27,7,7,0,0,7,2 (2ct 0st),0.259,
RM Hogg (AUS),1978-1984,38,69,7,7,0,0,7,1 (1ct 0st),0.101,
PM Hornibrook (AUS),1929-1930,6,11,7,7,0,0,7,2 (2ct 0st),0.636,
J Humphries (ENG),1908-1908,3,6,7,7,0,7,0,3 (3ct 0st),1.166,
A Jackson (AUS),1929-1931,8,16,7,7,0,0,7,2 (2ct 0st),0.437,
Jahurul Islam (BAN),2010-2013,7,13,7,7,0,0,7,2 (2ct 0st),0.538,
PA Jaques (AUS),2005-2008,11,22,7,7,0,0,7,2 (2ct 0st),0.318,
Javed Burki (PAK),1960-1969,25,42,7,7,0,0,7,2 (2ct 0st),0.166,
LR Johnson (WI),2014-2016,9,14,7,7,0,0,7,2 (2ct 0st),0.500,
SB Joshi (IND),1996-2000,15,28,7,7,0,0,7,1 (1ct 0st),0.250,
VG Kambli (IND),1993-1995,17,30,7,7,0,0,7,1 (1ct 0st),0.233,
HR Lance (SA),1962-1970,13,26,7,7,0,0,7,2 (2ct 0st),0.269,
CB Llewellyn (SA),1896-1912,15,26,7,7,0,0,7,2 (2ct 0st),0.269,
ML Love (AUS),2002-2003,5,10,7,7,0,0,7,3 (3ct 0st),0.700,
SJE Loxton (AUS),1948-1951,12,23,7,7,0,0,7,4 (4ct 0st),0.304,
MF Maharoof (SL),2004-2011,22,40,7,7,0,0,7,1 (1ct 0st),0.175,
DE Malcolm (ENG),1989-1997,40,73,7,7,0,0,7,1 (1ct 0st),0.095,
SL Malinga (SL),2004-2010,30,59,7,7,0,0,7,2 (2ct 0st),0.118,
Manzoor Elahi (PAK),1984-1995,6,10,7,7,0,0,7,2 (2ct 0st),0.700,
XM Marshall (WI),2005-2009,7,14,7,7,0,0,7,2 (2ct 0st),0.500,
S Matsikenyeri (ZIM),2003-2005,8,12,7,7,0,0,7,2 (2ct 0st),0.583,
TJ Matthews (AUS),1912-1912,8,12,7,7,0,0,7,2 (2ct 0st),0.583,
TMK Mawoyo (ZIM),2011-2016,11,20,7,7,0,0,7,2 (2ct 0st),0.350,
VM Merchant (IND),1933-1951,10,18,7,7,0,0,7,2 (2ct 0st),0.388,
C Milburn (ENG),1966-1969,9,14,7,7,0,0,7,2 (2ct 0st),0.500,
Mohammad Abbas (PAK),2017-2021,25,44,7,7,0,0,7,2 (2ct 0st),0.159,
Mohammad Rafique (BAN),2000-2008,33,48,7,7,0,0,7,1 (1ct 0st),0.145,
Mohammad Sami (PAK),2001-2012,36,66,7,7,0,0,7,2 (2ct 0st),0.106,
S Mushtaq Ali (IND),1934-1952,11,19,7,7,0,0,7,1 (1ct 0st),0.368,
Nazar Mohammad (PAK),1952-1952,5,8,7,7,0,0,7,2 (2ct 0st),0.875,
L Ngidi (SA),2018-2022,17,31,7,7,0,0,7,1 (1ct 0st),0.225,
ASM Oakman (ENG),1956-1956,2,4,7,7,0,0,7,3 (3ct 0st),1.750,
IE O'Brien (NZ),2005-2009,22,38,7,7,0,0,7,2 (2ct 0st),0.184,
WJ O'Reilly (AUS),1932-1946,27,50,7,7,0,0,7,2 (2ct 0st),0.140,
C Overton (ENG),2017-2022,8,14,7,7,0,0,7,2 (2ct 0st),0.500,
HH Pandya (IND),2017-2018,11,21,7,7,0,0,7,1 (1ct 0st),0.333,
AY Patel (NZ),2018-2023,14,27,7,7,0,0,7,2 (2ct 0st),0.259,
E Paynter (ENG),1931-1939,20,37,7,7,0,0,7,1 (1ct 0st),0.189,
JSE Price (ENG),1964-1972,15,28,7,7,0,0,7,2 (2ct 0st),0.250,
CAK Rajitha (SL),2018-2023,16,27,7,7,0,0,7,3 (3ct 0st),0.259,
AMB Rowan (SA),1947-1951,15,28,7,7,0,0,7,2 (2ct 0st),0.250,
Sami Aslam (PAK),2015-2017,13,25,7,7,0,0,7,2 (2ct 0st),0.280,
VJ Scott (NZ),1946-1952,10,14,7,7,0,0,7,2 (2ct 0st),0.500,
JED Sealy (WI),1930-1939,11,21,7,6,1,4,2,2 (1ct 1st),0.333,
Shamsur Rahman (BAN),2014-2014,6,11,7,7,0,0,7,2 (2ct 0st),0.636,
C Sharma (IND),1984-1989,23,40,7,7,0,0,7,1 (1ct 0st),0.175,
M Sherwin (ENG),1887-1888,3,6,7,5,2,5,0,4 (2ct 2st),1.166,
IJ Siedle (SA),1928-1936,18,29,7,7,0,0,7,2 (2ct 0st),0.241,
Sikander Bakht (PAK),1976-1983,26,48,7,7,0,0,7,1 (1ct 0st),0.145,
LPC Silva (SL),2006-2008,11,21,7,7,0,0,7,2 (2ct 0st),0.333,
MC Snedden (NZ),1981-1990,25,42,7,7,0,0,7,2 (2ct 0st),0.166,
DS Steele (ENG),1975-1976,8,16,7,7,0,0,7,2 (2ct 0st),0.437,
JWA Taylor (ENG),2012-2016,7,13,7,7,0,0,7,2 (2ct 0st),0.538,
SA Thomson (NZ),1990-1995,19,31,7,7,0,0,7,1 (1ct 0st),0.225,
EWT Tindill (NZ),1937-1947,5,8,7,6,1,6,0,2 (2ct 0st),0.875,
PHJ Trimborn (SA),1967-1970,4,8,7,7,0,0,7,2 (2ct 0st),0.875,
LJ Tucker (IRE),2023-2023,4,6,7,5,2,5,0,3 (3ct 0st),1.166,
TR Veivers (AUS),1963-1967,21,38,7,7,0,0,7,2 (2ct 0st),0.184,
Wajahatullah Wasti (PAK),1999-2000,6,10,7,7,0,0,7,3 (3ct 0st),0.700,
WW Whysall (ENG),1925-1930,4,7,7,7,0,0,7,2 (2ct 0st),1.000,
WM Woodfull (AUS),1926-1934,35,65,7,7,0,0,7,2 (2ct 0st),0.107,
RD Woolley (AUS),1983-1984,2,3,7,7,0,7,0,3 (3ct 0st),2.333,
Abid Ali (PAK),2019-2021,16,28,6,6,0,0,6,3 (3ct 0st),0.214,
EE Achong (WI),1930-1935,6,9,6,6,0,0,6,1 (1ct 0st),0.666,
CJ Adams (ENG),1999-2000,5,7,6,6,0,0,6,3 (3ct 0st),0.857,
AB Agarkar (IND),1998-2006,26,48,6,6,0,0,6,1 (1ct 0st),0.125,
HK Badani (IND),2001-2001,4,7,6,6,0,0,6,2 (2ct 0st),0.857,
AA Baig (IND),1959-1967,10,17,6,6,0,0,6,1 (1ct 0st),0.352,
OAC Banks (WI),2003-2005,10,20,6,6,0,0,6,3 (3ct 0st),0.300,
Basit Ali (PAK),1993-1995,19,35,6,6,0,0,6,1 (1ct 0st),0.171,
AJ Bell (SA),1929-1935,16,27,6,6,0,0,6,1 (1ct 0st),0.222,
TL Best (WI),2003-2013,25,46,6,6,0,0,6,1 (1ct 0st),0.130,
C Blythe (ENG),1901-1910,19,37,6,6,0,0,6,1 (1ct 0st),0.162,
SM Boland (AUS),2021-2023,10,19,6,6,0,0,6,2 (2ct 0st),0.315,
RS Bopara (ENG),2007-2012,13,20,6,6,0,0,6,2 (2ct 0st),0.300,
JR Bracey (ENG),2021-2021,2,4,6,6,0,6,0,2 (2ct 0st),1.500,
GE Bradburn (NZ),1990-2001,7,11,6,6,0,0,6,2 (2ct 0st),0.545,
W Brockwell (ENG),1893-1899,7,13,6,6,0,0,6,1 (1ct 0st),0.461,
DJ Capel (ENG),1987-1990,15,24,6,6,0,0,6,2 (2ct 0st),0.250,
W Carkeek (AUS),1912-1912,6,9,6,6,0,6,0,2 (2ct 0st),0.666,
E Chigumbura (ZIM),2004-2014,14,24,6,6,0,0,6,2 (2ct 0st),0.250,
WM Clark (AUS),1977-1979,10,18,6,6,0,0,6,1 (1ct 0st),0.333,
CD Collymore (WI),1999-2007,30,58,6,6,0,0,6,1 (1ct 0st),0.103,
DP Conway (NZ),2021-2023,16,32,6,6,0,0,6,2 (2ct 0st),0.187,
SC Cook (SA),2016-2017,11,20,6,6,0,0,6,2 (2ct 0st),0.300,
V Dahiya (IND),2000-2000,2,4,6,6,0,6,0,3 (3ct 0st),1.500,
RL Dias (SL),1982-1987,20,30,6,6,0,0,6,2 (2ct 0st),0.200,
AIC Dodemaide (AUS),1987-1992,10,17,6,6,0,0,6,2 (2ct 0st),0.352,
PA Emery (AUS),1994-1994,1,2,6,5,1,5,0,5 (4ct 1st),3.000,
FL Fane (ENG),1906-1910,14,27,6,6,0,0,6,1 (1ct 0st),0.222,
CV Gadkari (IND),1953-1955,6,10,6,6,0,0,6,3 (3ct 0st),0.600,
DRA Gehrs (AUS),1904-1911,6,11,6,6,0,0,6,2 (2ct 0st),0.545,
Y Goonasekera (SL),1983-1983,2,3,6,6,0,0,6,4 (4ct 0st),2.000,
AH Gray (WI),1986-1987,5,10,6,6,0,0,6,3 (3ct 0st),0.600,
EJ Gray (NZ),1983-1988,10,17,6,6,0,0,6,2 (2ct 0st),0.352,
DAS Gunaratne (SL),2016-2017,6,12,6,6,0,0,6,2 (2ct 0st),0.500,
MD Gunathilaka (SL),2017-2018,8,15,6,6,0,0,6,1 (1ct 0st),0.400,
WA Hadlee (NZ),1937-1951,11,17,6,6,0,0,6,2 (2ct 0st),0.352,
PGZ Harris (NZ),1955-1965,9,15,6,6,0,0,6,3 (3ct 0st),0.400,
Hasan Ali (PAK),2017-2023,22,43,6,6,0,0,6,1 (1ct 0st),0.139,
TP Horan (AUS),1877-1885,15,28,6,6,0,0,6,1 (1ct 0st),0.214,
HV Hordern (AUS),1911-1912,7,13,6,6,0,0,6,2 (2ct 0st),0.461,
SMS Kaluperuma (SL),1984-1988,4,6,6,6,0,0,6,2 (2ct 0st),1.000,
CK Kapugedera (SL),2006-2009,8,15,6,6,0,0,6,2 (2ct 0st),0.400,
MF Kent (AUS),1981-1981,3,6,6,6,0,0,6,3 (3ct 0st),1.000,
R Kilner (ENG),1924-1926,9,13,6,6,0,0,6,2 (2ct 0st),0.461,
CBRLS Kumara (SL),2016-2023,26,43,6,6,0,0,6,1 (1ct 0st),0.139,
James Langridge (ENG),1933-1946,8,15,6,6,0,0,6,2 (2ct 0st),0.400,
AZ Lees (ENG),2022-2022,10,19,6,6,0,0,6,2 (2ct 0st),0.315,
CN McCarthy (SA),1948-1951,15,26,6,6,0,0,6,1 (1ct 0st),0.230,
PS McDonnell (AUS),1880-1888,19,34,6,6,0,0,6,2 (2ct 0st),0.176,
PJ Martin (ENG),1995-1997,8,13,6,6,0,0,6,1 (1ct 0st),0.461,
TBA May (AUS),1987-1995,24,46,6,6,0,0,6,1 (1ct 0st),0.130,
Mehrab Hossain (BAN),2000-2003,9,11,6,6,0,2,4,2 (2ct 0st),0.545,
CR Miller (AUS),1998-2001,18,34,6,6,0,0,6,1 (1ct 0st),0.176,
FM Misson (AUS),1960-1961,5,10,6,6,0,0,6,2 (2ct 0st),0.600,
Mohammad Ilyas (PAK),1964-1969,10,19,6,6,0,0,6,2 (2ct 0st),0.315,
Mohammad Mithun (BAN),2018-2021,10,15,6,6,0,0,6,1 (1ct 0st),0.400,
A Mukund (IND),2011-2017,7,14,6,6,0,0,6,2 (2ct 0st),0.428,
AD Mullally (ENG),1996-2001,19,34,6,6,0,0,6,1 (1ct 0st),0.176,
DJ Murray (NZ),1994-1995,8,14,6,6,0,0,6,2 (2ct 0st),0.428,
Mushfiqur Rahman (BAN),2001-2004,10,15,6,6,0,0,6,2 (2ct 0st),0.400,
Nadeem Abbasi (PAK),1989-1989,3,5,6,6,0,6,0,2 (2ct 0st),1.200,
KK Nair (IND),2016-2017,6,12,6,6,0,0,6,2 (2ct 0st),0.500,
BP Nash (WI),2008-2011,21,37,6,6,0,0,6,1 (1ct 0st),0.162,
LJ Nash (AUS),1932-1937,2,4,6,6,0,0,6,2 (2ct 0st),1.500,
A Nortje (SA),2019-2023,19,32,6,6,0,0,6,2 (2ct 0st),0.187,
SB O'Connor (NZ),1997-2001,19,35,6,6,0,0,6,2 (2ct 0st),0.171,
ML Page (NZ),1930-1937,14,22,6,6,0,0,6,2 (2ct 0st),0.272,
BH Pairaudeau (WI),1953-1957,13,25,6,6,0,0,6,1 (1ct 0st),0.240,
JT Partridge (SA),1963-1965,11,20,6,6,0,0,6,1 (1ct 0st),0.300,
MM Patel (IND),2006-2011,13,25,6,6,0,0,6,2 (2ct 0st),0.240,
KR Patterson (AUS),2019-2019,2,4,6,6,0,0,6,2 (2ct 0st),1.500,
JL Pattinson (AUS),2011-2020,21,40,6,6,0,0,6,1 (1ct 0st),0.150,
DB Pithey (SA),1963-1967,8,16,6,6,0,0,6,2 (2ct 0st),0.375,
BKV Prasad (IND),1996-2001,33,59,6,6,0,0,6,1 (1ct 0st),0.101,
KTGD Prasad (SL),2008-2015,25,47,6,6,0,0,6,2 (2ct 0st),0.127,
SLV Raju (IND),1990-2001,28,52,6,6,0,0,6,1 (1ct 0st),0.115,
WV Raman (IND),1988-1997,11,21,6,6,0,0,6,2 (2ct 0st),0.285,
CPH Ramanayake (SL),1988-1993,18,30,6,6,0,0,6,1 (1ct 0st),0.200,
FL Reifer (WI),1997-2009,6,12,6,6,0,0,6,2 (2ct 0st),0.500,
PE Richardson (ENG),1956-1963,34,65,6,6,0,0,6,1 (1ct 0st),0.092,
JDB Robertson (ENG),1947-1952,11,19,6,6,0,0,6,1 (1ct 0st),0.315,
PADLR Sandakan (SL),2016-2018,11,21,6,6,0,0,6,1 (1ct 0st),0.285,
S Shivnarine (WI),1978-1979,8,13,6,6,0,0,6,2 (2ct 0st),0.461,
Shoriful Islam (BAN),2021-2023,7,13,6,6,0,0,6,1 (1ct 0st),0.461,
JM Sims (ENG),1935-1937,4,8,6,6,0,0,6,3 (3ct 0st),0.750,
RP Singh (IND),2006-2011,14,25,6,6,0,0,6,1 (1ct 0st),0.240,
MJ Stewart (ENG),1962-1964,8,16,6,6,0,0,6,2 (2ct 0st),0.375,
AE Stoddart (ENG),1888-1898,16,29,6,6,0,0,6,1 (1ct 0st),0.206,
Tapash Baisya (BAN),2002-2005,21,29,6,6,0,0,6,1 (1ct 0st),0.206,
Lord Tennyson (ENG),1913-1921,9,16,6,6,0,0,6,2 (2ct 0st),0.375,
TL Tsolekile (SA),2004-2004,3,5,6,6,0,6,0,3 (3ct 0st),1.200,
MG Vandort (SL),2001-2008,20,39,6,6,0,0,6,1 (1ct 0st),0.153,
S van Zyl (SA),2014-2016,12,20,6,6,0,0,6,1 (1ct 0st),0.300,
MA Vermeulen (ZIM),2002-2014,9,14,6,6,0,0,6,1 (1ct 0st),0.428,
CF Walters (ENG),1933-1934,11,21,6,6,0,0,6,2 (2ct 0st),0.285,
JC White (ENG),1921-1931,15,29,6,6,0,0,6,1 (1ct 0st),0.206,
GC Wilson (IRE),2018-2019,2,4,6,6,0,6,0,3 (3ct 0st),1.500,
B Wood (ENG),1972-1978,12,23,6,6,0,0,6,2 (2ct 0st),0.260,
GEC Wood (ENG),1924-1924,3,6,6,5,1,5,0,2 (2ct 0st),1.000,
RA Young (ENG),1907-1908,2,4,6,6,0,6,0,2 (2ct 0st),1.500,
WA Young (NZ),2020-2023,13,26,6,6,0,0,6,1 (1ct 0st),0.230,
Alok Kapali (BAN),2002-2006,17,25,5,5,0,0,5,2 (2ct 0st),0.200,
Aminul Islam (BAN),2000-2002,13,16,5,5,0,0,5,3 (3ct 0st),0.312,
Asif Masood (PAK),1969-1977,16,29,5,5,0,0,5,1 (1ct 0st),0.172,
Atiq-uz-Zaman (PAK),2000-2000,1,2,5,5,0,5,0,3 (3ct 0st),2.500,
XC Balaskas (SA),1930-1939,9,14,5,5,0,0,5,1 (1ct 0st),0.357,
BA Barnett (AUS),1938-1938,4,6,5,3,2,3,0,3 (2ct 1st),0.833,
MJ Bennett (AUS),1984-1985,3,5,5,5,0,0,5,1 (1ct 0st),1.000,
MC Bird (ENG),1910-1914,10,20,5,5,0,0,5,3 (3ct 0st),0.250,
RW Blair (NZ),1953-1964,19,28,5,5,0,0,5,1 (1ct 0st),0.178,
RC Blunt (NZ),1930-1932,9,14,5,5,0,0,5,2 (2ct 0st),0.357,
KD Boyce (WI),1971-1976,21,41,5,5,0,0,5,1 (1ct 0st),0.121,
PVD Chameera (SL),2015-2021,12,22,5,5,0,0,5,1 (1ct 0st),0.227,
NGB Cook (ENG),1983-1989,15,25,5,5,0,0,5,2 (2ct 0st),0.200,
CS Cowdrey (ENG),1984-1988,6,12,5,5,0,0,5,2 (2ct 0st),0.416,
CE Cuffy (WI),1994-2002,15,26,5,5,0,0,5,1 (1ct 0st),0.192,
SH Curnow (SA),1930-1932,7,11,5,5,0,0,5,3 (3ct 0st),0.454,
SM Curran (ENG),2018-2021,24,46,5,5,0,0,5,2 (2ct 0st),0.108,
OC da Costa (WI),1930-1935,5,7,5,5,0,0,5,3 (3ct 0st),0.714,
EL Dalton (SA),1929-1939,15,26,5,5,0,0,5,2 (2ct 0st),0.192,
WM Darling (AUS),1978-1979,14,25,5,5,0,0,5,2 (2ct 0st),0.200,
AM de Silva (SL),1993-1993,3,4,5,4,1,4,0,2 (2ct 0st),1.250,
DS de Silva (SL),1982-1984,12,19,5,5,0,0,5,2 (2ct 0st),0.263,
KSC de Silva (SL),1997-1999,8,14,5,5,0,0,5,2 (2ct 0st),0.357,
RV Divecha (IND),1951-1952,5,7,5,5,0,0,5,2 (2ct 0st),0.714,
TM Dowlin (WI),2009-2010,6,11,5,5,0,0,5,2 (2ct 0st),0.454,
NF Druce (ENG),1897-1898,5,8,5,5,0,1,4,2 (2ct 0st),0.625,
CE Eksteen (SA),1993-2000,7,14,5,5,0,0,5,1 (1ct 0st),0.357,
RMS Eranga (SL),2011-2016,19,36,5,5,0,0,5,1 (1ct 0st),0.138,
E Evans (AUS),1881-1886,6,10,5,5,0,0,5,2 (2ct 0st),0.500,
AE Fagg (ENG),1936-1939,5,10,5,5,0,0,5,2 (2ct 0st),0.500,
Faheem Ashraf (PAK),2018-2022,16,30,5,5,0,0,5,1 (1ct 0st),0.166,
N Pradeep (SL),2011-2017,28,53,5,5,0,0,5,1 (1ct 0st),0.094,
KNM Fernando (SL),2023-2023,5,8,5,5,0,0,5,2 (2ct 0st),0.625,
FGJ Ford (ENG),1894-1895,5,9,5,5,0,0,5,2 (2ct 0st),0.555,
CM Francois (SA),1922-1923,5,10,5,5,0,0,5,3 (3ct 0st),0.500,
EW Freeman (AUS),1968-1970,11,21,5,5,0,0,5,1 (1ct 0st),0.238,
DK Gaekwad (IND),1952-1961,11,17,5,5,0,0,5,1 (1ct 0st),0.294,
D Gamsy (SA),1970-1970,2,4,5,5,0,5,0,3 (3ct 0st),1.250,
AE Greenidge (WI),1978-1979,6,10,5,5,0,0,5,2 (2ct 0st),0.500,
AFG Griffith (WI),1997-2000,14,24,5,5,0,0,5,1 (1ct 0st),0.208,
SC Griffith (ENG),1948-1949,3,6,5,5,0,5,0,3 (3ct 0st),0.833,
W Gunn (ENG),1887-1899,11,21,5,5,0,0,5,2 (2ct 0st),0.238,
JN Hamilton (WI),2019-2019,1,2,5,5,0,5,0,3 (3ct 0st),2.500,
BR Hartland (NZ),1992-1994,9,15,5,5,0,0,5,3 (3ct 0st),0.333,
Hasan Raza (PAK),1996-2005,7,13,5,5,0,0,5,2 (2ct 0st),0.384,
CMH Hathorn (SA),1902-1911,12,23,5,5,0,0,5,1 (1ct 0st),0.217,
EE Hemmings (ENG),1982-1991,16,28,5,5,0,0,5,1 (1ct 0st),0.178,
ND Hirwani (IND),1988-1996,17,31,5,5,0,0,5,1 (1ct 0st),0.161,
RG Holland (AUS),1984-1986,11,18,5,5,0,0,5,2 (2ct 0st),0.277,
DT Hondo (ZIM),2001-2005,9,13,5,5,0,0,5,2 (2ct 0st),0.384,
EAC Hunte (WI),1930-1930,3,6,5,5,0,5,0,3 (3ct 0st),0.833,
Ijaz Butt (PAK),1959-1962,8,13,5,5,0,2,3,2 (2ct 0st),0.384,
Ikram Alikhil (AFG),2019-2019,1,2,5,4,1,4,0,3 (2ct 1st),2.500,
RK Illingworth (ENG),1991-1995,9,14,5,5,0,0,5,2 (2ct 0st),0.357,
Ishan Kishan (IND),2023-2023,2,4,5,5,0,5,0,3 (3ct 0st),1.250,
A Jadeja (IND),1992-2000,15,25,5,5,0,0,5,2 (2ct 0st),0.200,
KA Jamieson (NZ),2020-2022,16,32,5,5,0,0,5,1 (1ct 0st),0.156,
TJ Jenner (AUS),1970-1975,9,18,5,5,0,0,5,2 (2ct 0st),0.277,
CB Jennings (AUS),1912-1912,6,9,5,5,0,0,5,2 (2ct 0st),0.555,
VWC Jupp (ENG),1921-1928,8,15,5,5,0,0,5,1 (1ct 0st),0.333,
AS Kennedy (ENG),1922-1923,5,9,5,5,0,0,5,2 (2ct 0st),0.555,
D Kenyon (ENG),1951-1955,8,15,5,5,0,0,5,2 (2ct 0st),0.333,
CL King (WI),1976-1980,9,17,5,5,0,0,5,2 (2ct 0st),0.294,
FM King (WI),1953-1956,14,26,5,5,0,0,5,2 (2ct 0st),0.192,
R Lamba (IND),1986-1987,4,7,5,5,0,0,5,3 (3ct 0st),0.714,
GR Larsen (NZ),1994-1996,8,15,5,5,0,0,5,2 (2ct 0st),0.333,
JDF Larter (ENG),1962-1965,10,20,5,5,0,0,5,2 (2ct 0st),0.250,
RT Latham (NZ),1992-1993,4,8,5,5,0,0,5,2 (2ct 0st),0.625,
JD Lindsay (SA),1947-1947,3,6,5,4,1,4,0,2 (1ct 1st),0.833,
FA Lowson (ENG),1951-1955,7,12,5,5,0,0,5,2 (2ct 0st),0.416,
GG Macaulay (ENG),1923-1933,8,14,5,5,0,0,5,1 (1ct 0st),0.357,
PE McEwan (NZ),1980-1984,4,8,5,5,0,0,5,2 (2ct 0st),0.625,
NAM McLean (WI),1998-2001,19,33,5,5,0,0,5,1 (1ct 0st),0.151,
EDAS McMorris (WI),1958-1966,13,25,5,5,0,0,5,1 (1ct 0st),0.200,
Mahmood Hussain (PAK),1952-1962,27,45,5,5,0,0,5,1 (1ct 0st),0.111,
JAH Marshall (NZ),2005-2008,7,13,5,5,0,0,5,1 (1ct 0st),0.384,
JW Martin (AUS),1960-1967,8,16,5,5,0,0,5,3 (3ct 0st),0.312,
EA Martindale (WI),1933-1939,10,17,5,5,0,0,5,1 (1ct 0st),0.294,
HH Massie (AUS),1881-1885,9,17,5,5,0,0,5,1 (1ct 0st),0.294,
GJ Maxwell (AUS),2013-2017,7,12,5,5,0,0,5,2 (2ct 0st),0.416,
RTM Mendis (SL),2021-2023,14,26,5,5,0,0,5,1 (1ct 0st),0.192,
CA Milton (ENG),1958-1959,6,12,5,5,0,0,5,2 (2ct 0st),0.416,
Mohammad Amir (PAK),2009-2019,36,69,5,5,0,0,5,1 (1ct 0st),0.072,
Mohammad Sharif (BAN),2001-2007,10,12,5,5,0,0,5,2 (2ct 0st),0.416,
CH Morris (SA),2016-2017,4,8,5,5,0,0,5,2 (2ct 0st),0.625,
Naseem Shah (PAK),2019-2023,17,28,5,5,0,0,5,1 (1ct 0st),0.178,
Nayeem Hasan (BAN),2018-2022,8,15,5,5,0,0,5,3 (3ct 0st),0.333,
A Nehra (IND),1999-2004,17,30,5,5,0,0,5,1 (1ct 0st),0.166,
AD Ogilvie (AUS),1977-1978,5,10,5,5,0,0,5,1 (1ct 0st),0.500,
NV Ojha (IND),2015-2015,1,2,5,4,1,4,0,3 (2ct 1st),2.500,
GAE Paine (ENG),1935-1935,4,7,5,5,0,0,5,2 (2ct 0st),0.714,
BP Patterson (WI),1986-1992,28,54,5,5,0,0,5,1 (1ct 0st),0.092,
TRO Payne (WI),1986-1986,1,2,5,5,0,5,0,3 (3ct 0st),2.500,
IAR Peebles (ENG),1927-1931,13,21,5,5,0,0,5,1 (1ct 0st),0.238,
SJ Pegler (SA),1910-1924,16,24,5,5,0,0,5,2 (2ct 0st),0.208,
N Phillip (WI),1978-1979,9,15,5,5,0,0,5,2 (2ct 0st),0.333,
PI Philpott (AUS),1965-1966,8,15,5,5,0,0,5,2 (2ct 0st),0.333,
DL Piedt (SA),2014-2019,9,16,5,5,0,0,5,2 (2ct 0st),0.312,
BA Pocock (NZ),1993-1997,15,24,5,5,0,0,5,1 (1ct 0st),0.208,
MJ Potts (ENG),2022-2023,6,11,5,5,0,0,5,2 (2ct 0st),0.454,
PH Punjabi (IND),1955-1955,5,9,5,5,0,0,5,1 (1ct 0st),0.555,
RJ Quiney (AUS),2012-2012,2,4,5,5,0,0,5,2 (2ct 0st),1.250,
GO Rabone (NZ),1949-1955,12,19,5,5,0,0,5,2 (2ct 0st),0.263,
AJ Redmond (NZ),2008-2013,8,12,5,5,0,0,5,2 (2ct 0st),0.416,
BA Reid (AUS),1985-1992,27,46,5,5,0,0,5,1 (1ct 0st),0.108,
RA Reifer (WI),2017-2023,8,15,5,5,0,0,5,2 (2ct 0st),0.333,
T Richardson (ENG),1893-1898,14,25,5,5,0,0,5,1 (1ct 0st),0.200,
KE Rigg (AUS),1931-1937,8,16,5,5,0,0,5,1 (1ct 0st),0.312,
DT Ring (AUS),1948-1953,13,26,5,5,0,0,5,1 (1ct 0st),0.192,
CA Roach (WI),1928-1935,16,23,5,5,0,0,5,1 (1ct 0st),0.217,
Robiul Islam (BAN),2010-2014,9,17,5,5,0,0,5,1 (1ct 0st),0.294,
SD Robson (ENG),2014-2014,7,14,5,5,0,0,5,1 (1ct 0st),0.357,
L Ronchi (NZ),2015-2016,4,8,5,5,0,5,0,2 (2ct 0st),0.625,
IDK Salisbury (ENG),1992-2000,15,27,5,5,0,0,5,2 (2ct 0st),0.185,
DP Samaraweera (SL),1993-1995,7,9,5,5,0,0,5,2 (2ct 0st),0.555,
JV Saunders (AUS),1902-1908,14,27,5,5,0,0,5,2 (2ct 0st),0.185,
Shafqat Rana (PAK),1964-1969,5,9,5,5,0,0,5,2 (2ct 0st),0.555,
Shahid Nazir (PAK),1996-2007,15,29,5,5,0,0,5,2 (2ct 0st),0.172,
RJ Sidebottom (ENG),2001-2010,22,37,5,5,0,0,5,1 (1ct 0st),0.135,
Sikandar Raza (ZIM),2013-2021,17,30,5,5,0,0,5,1 (1ct 0st),0.166,
LMP Simmons (WI),2009-2011,8,15,5,5,0,0,5,1 (1ct 0st),0.333,
RT Simpson (ENG),1948-1955,27,51,5,5,0,0,5,2 (2ct 0st),0.098,
RR Singh (IND),1998-1998,1,2,5,5,0,0,5,3 (3ct 0st),2.500,
CL Smith (ENG),1983-1986,8,16,5,5,0,0,5,2 (2ct 0st),0.312,
CW Smith (WI),1960-1962,5,10,5,4,1,1,3,3 (3ct 0st),0.500,
ET Smith (ENG),2003-2003,3,6,5,5,0,0,5,2 (2ct 0st),0.833,
Sohag Gazi (BAN),2012-2014,10,18,5,5,0,0,5,1 (1ct 0st),0.277,
S Sreesanth (IND),2006-2011,27,50,5,5,0,0,5,2 (2ct 0st),0.100,
AG Steel (ENG),1880-1888,13,24,5,5,0,0,5,1 (1ct 0st),0.208,
CT Studd (ENG),1882-1883,5,10,5,5,0,0,5,2 (2ct 0st),0.500,
R Subba Row (ENG),1958-1961,13,23,5,5,0,0,5,1 (1ct 0st),0.217,
PL Symcox (SA),1993-1998,20,35,5,5,0,0,5,2 (2ct 0st),0.142,
SN Thakur (IND),2018-2023,10,20,5,5,0,0,5,2 (2ct 0st),0.250,
GJ Thompson (ENG),1909-1910,6,12,5,5,0,0,5,2 (2ct 0st),0.416,
DT Tiripano (ZIM),2014-2023,16,27,5,5,0,0,5,1 (1ct 0st),0.185,
RW Tolchard (ENG),1977-1977,4,8,5,5,0,0,5,1 (1ct 0st),0.625,
TE Tsiga (ZIM),2023-2023,2,3,5,5,0,5,0,2 (2ct 0st),1.666,
RG Twose (NZ),1995-1999,16,28,5,5,0,0,5,1 (1ct 0st),0.178,
KG Viljoen (SA),1930-1949,27,46,5,5,0,0,5,1 (1ct 0st),0.108,
Wahab Riaz (PAK),2010-2018,27,52,5,5,0,0,5,1 (1ct 0st),0.096,
PM Walker (ENG),1960-1960,3,6,5,5,0,0,5,2 (2ct 0st),0.833,
WM Wallace (NZ),1937-1953,13,20,5,5,0,0,5,1 (1ct 0st),0.250,
JA Warrican (WI),2015-2023,15,26,5,5,0,0,5,1 (1ct 0st),0.192,
Wazir Mohammad (PAK),1952-1959,20,37,5,5,0,0,5,1 (1ct 0st),0.135,
UWMBCA Welegedara (SL),2007-2014,21,36,5,5,0,0,5,1 (1ct 0st),0.138,
DM Wellham (AUS),1981-1987,6,10,5,5,0,0,5,2 (2ct 0st),0.500,
AB Williams (WI),1978-1979,7,12,5,5,0,0,5,2 (2ct 0st),0.416,
SMJ Woods (AUS/ENG),1888-1896,6,10,5,5,0,0,5,3 (3ct 0st),0.500,
Yasir Ali (BAN),2021-2022,6,11,5,5,0,0,5,2 (2ct 0st),0.454,
JA Young (ENG),1947-1949,8,14,5,5,0,0,5,1 (1ct 0st),0.357,
Zahid Fazal (PAK),1990-1995,9,16,5,5,0,0,5,1 (1ct 0st),0.312,
Zubayr Hamza (SA),2019-2022,6,9,5,5,0,0,5,2 (2ct 0st),0.555,
Zulfiqar Ahmed (PAK),1952-1956,9,16,5,5,0,0,5,1 (1ct 0st),0.312,
KJ Abbott (SA),2013-2017,11,21,4,4,0,0,4,1 (1ct 0st),0.190,
Abdul Malik (1) (AFG),2021-2023,2,4,4,4,0,0,4,2 (2ct 0st),1.000,
Abdur Razzak (BAN),2006-2018,13,21,4,4,0,0,4,1 (1ct 0st),0.190,
EL a'Beckett (AUS),1928-1932,4,8,4,4,0,0,4,2 (2ct 0st),0.500,
NAT Adcock (SA),1953-1962,26,48,4,4,0,0,4,1 (1ct 0st),0.083,
PJW Allott (ENG),1981-1985,13,24,4,4,0,0,4,1 (1ct 0st),0.166,
S Amarnath (IND),1976-1978,10,17,4,4,0,0,4,2 (2ct 0st),0.235,
SD Anurasiri (SL),1986-1998,18,27,4,4,0,0,4,1 (1ct 0st),0.148,
R Appleyard (ENG),1954-1956,9,18,4,4,0,0,4,2 (2ct 0st),0.222,
KJ Arnott (ZIM),1992-1993,4,6,4,4,0,0,4,2 (2ct 0st),0.666,
A Balbirnie (IRE),2018-2023,7,12,4,4,0,0,4,1 (1ct 0st),0.333,
HMCM Bandara (SL),1998-2006,8,15,4,4,0,0,4,1 (1ct 0st),0.266,
SB Bangar (IND),2001-2002,12,22,4,4,0,0,4,1 (1ct 0st),0.181,
PT Barton (NZ),1961-1963,7,11,4,4,0,0,4,2 (2ct 0st),0.363,
G Bean (ENG),1892-1892,3,6,4,4,0,0,4,2 (2ct 0st),0.666,
STR Binny (IND),2014-2015,6,9,4,4,0,0,4,1 (1ct 0st),0.444,
LS Birkett (WI),1930-1931,4,5,4,4,0,0,4,2 (2ct 0st),0.800,
EA Brandes (ZIM),1992-1999,10,18,4,4,0,0,4,1 (1ct 0st),0.222,
IG Butler (NZ),2002-2004,8,14,4,4,0,0,4,1 (1ct 0st),0.285,
MR Bynoe (WI),1959-1967,4,8,4,4,0,0,4,1 (1ct 0st),0.500,
GS Camacho (WI),1968-1971,11,18,4,4,0,0,4,1 (1ct 0st),0.222,
T Chanderpaul (WI),2022-2023,8,15,4,4,0,0,4,2 (2ct 0st),0.266,
S Chattergoon (WI),2008-2008,4,8,4,4,0,0,4,1 (1ct 0st),0.500,
SR Clark (AUS),2006-2009,24,48,4,4,0,0,4,1 (1ct 0st),0.083,
IA Colquhoun (NZ),1955-1955,2,3,4,4,0,4,0,2 (2ct 0st),1.333,
WW Daniel (WI),1976-1984,10,20,4,4,0,0,4,1 (1ct 0st),0.200,
CA Davis (WI),1968-1973,15,27,4,4,0,0,4,1 (1ct 0st),0.148,
HT Davis (NZ),1994-1997,5,9,4,4,0,0,4,1 (1ct 0st),0.444,
EAR de Silva (SL),1985-1991,10,16,4,4,0,0,4,1 (1ct 0st),0.250,
AJ Doolan (AUS),2014-2014,4,8,4,4,0,0,4,2 (2ct 0st),0.500,
CJ Drum (NZ),2001-2002,5,9,4,4,0,0,4,1 (1ct 0st),0.444,
MA Ealham (ENG),1996-1998,8,13,4,4,0,0,4,1 (1ct 0st),0.307,
MK Elgie (SA),1961-1962,3,6,4,4,0,0,4,2 (2ct 0st),0.666,
NH Fairbrother (ENG),1987-1993,10,15,4,4,0,0,4,2 (2ct 0st),0.266,
TCB Fernando (SL),2001-2002,9,17,4,4,0,0,4,2 (2ct 0st),0.235,
JJ Ferris (AUS/ENG),1887-1892,9,16,4,4,0,0,4,1 (1ct 0st),0.250,
A Fielder (ENG),1904-1908,6,12,4,4,0,0,4,2 (2ct 0st),0.333,
AP Freeman (ENG),1924-1929,12,23,4,4,0,0,4,1 (1ct 0st),0.173,
AB Fudadin (WI),2012-2012,3,5,4,4,0,0,4,2 (2ct 0st),0.800,
LH Gay (ENG),1894-1894,1,2,4,3,1,3,0,3 (2ct 1st),2.000,
JM Ghorpade (IND),1953-1959,8,12,4,4,0,0,4,1 (1ct 0st),0.333,
PA Gibb (ENG),1938-1946,8,14,4,3,1,3,0,2 (1ct 1st),0.285,
R Gilchrist (WI),1957-1959,13,23,4,4,0,0,4,1 (1ct 0st),0.173,
HC Griffith (WI),1928-1933,13,18,4,4,0,0,4,1 (1ct 0st),0.222,
NE Haig (ENG),1921-1930,5,10,4,4,0,0,4,2 (2ct 0st),0.400,
AE Hall (SA),1923-1931,7,14,4,4,0,0,4,1 (1ct 0st),0.285,
SR Harmer (SA),2015-2023,10,16,4,4,0,0,4,2 (2ct 0st),0.250,
M Hayward (SA),1999-2004,16,31,4,4,0,0,4,1 (1ct 0st),0.129,
GR Hazlitt (AUS),1907-1912,9,15,4,4,0,0,4,1 (1ct 0st),0.266,
JT Hearne (ENG),1892-1899,12,22,4,4,0,0,4,2 (2ct 0st),0.181,
K Higgs (ENG),1965-1968,15,27,4,4,0,0,4,1 (1ct 0st),0.148,
JW Hitch (ENG),1911-1921,7,12,4,4,0,0,4,1 (1ct 0st),0.333,
AJ Hollioake (ENG),1997-1998,4,6,4,4,0,0,4,1 (1ct 0st),0.666,
ERT Holmes (ENG),1935-1935,5,9,4,4,0,0,4,2 (2ct 0st),0.444,
ND Howard (ENG),1951-1952,4,7,4,4,0,0,4,2 (2ct 0st),0.571,
Ihsanullah (AFG),2019-2019,3,6,4,4,0,0,4,2 (2ct 0st),0.666,
Imran Nazir (PAK),1999-2002,8,14,4,4,0,0,4,1 (1ct 0st),0.285,
RJ Inverarity (AUS),1968-1972,6,12,4,4,0,0,4,2 (2ct 0st),0.333,
M Jahangir Khan (IND),1932-1936,4,7,4,4,0,0,4,3 (3ct 0st),0.571,
RO Jenkins (ENG),1948-1952,9,18,4,4,0,0,4,1 (1ct 0st),0.222,
IJ Jones (ENG),1964-1968,15,27,4,4,0,0,4,1 (1ct 0st),0.148,
PEW Jones (WI),1948-1951,9,18,4,4,0,0,4,1 (1ct 0st),0.222,
SP Jones (ENG),2002-2005,18,35,4,4,0,0,4,1 (1ct 0st),0.114,
BP Julian (AUS),1993-1995,7,14,4,4,0,0,4,1 (1ct 0st),0.285,
RR Jumadeen (WI),1972-1979,12,22,4,4,0,0,4,2 (2ct 0st),0.181,
Junaid Khan (PAK),2011-2015,22,43,4,4,0,0,4,2 (2ct 0st),0.093,
JL Kerr (NZ),1931-1937,7,10,4,4,0,0,4,2 (2ct 0st),0.400,
Khan Mohammad (PAK),1952-1958,13,22,4,4,0,0,4,2 (2ct 0st),0.181,
JJ Krejza (AUS),2008-2008,2,4,4,4,0,0,4,3 (3ct 0st),1.000,
AG Kripal Singh (IND),1955-1964,14,25,4,4,0,0,4,1 (1ct 0st),0.160,
PD Lashley (WI),1960-1966,4,8,4,4,0,0,4,2 (2ct 0st),0.500,
WH Lockwood (ENG),1893-1902,12,20,4,4,0,0,4,2 (2ct 0st),0.200,
JE McConnon (ENG),1954-1954,2,4,4,4,0,0,4,4 (4ct 0st),1.000,
TR McKibbin (AUS),1895-1898,5,10,4,4,0,0,4,2 (2ct 0st),0.400,
DL Maddy (ENG),1999-2000,3,5,4,4,0,0,4,1 (1ct 0st),0.800,
Mahmudul Hasan Joy (BAN),2021-2023,9,17,4,4,0,0,4,2 (2ct 0st),0.235,
Manjural Islam (BAN),2001-2004,17,22,4,4,0,0,4,1 (1ct 0st),0.181,
FT Mann (ENG),1922-1923,5,9,4,4,0,0,4,1 (1ct 0st),0.444,
CR Matthews (SA),1992-1995,18,33,4,4,0,0,4,2 (2ct 0st),0.121,
B Mavuta (ZIM),2018-2023,4,7,4,4,0,0,4,2 (2ct 0st),0.571,
CP Mead (ENG),1911-1928,17,31,4,4,0,0,4,1 (1ct 0st),0.129,
MG Melle (SA),1950-1953,7,12,4,4,0,0,4,2 (2ct 0st),0.333,
KD Mills (NZ),2004-2009,19,33,4,4,0,0,4,1 (1ct 0st),0.121,
Mohammad Akram (PAK),1995-2001,9,15,4,4,0,0,4,1 (1ct 0st),0.266,
Mohammad Nawaz (3) (PAK),2016-2022,6,12,4,4,0,0,4,2 (2ct 0st),0.333,
Mohammad Nazir (PAK),1969-1983,14,23,4,4,0,0,4,1 (1ct 0st),0.173,
Mohammad Salim (BAN),2003-2003,2,2,4,3,1,3,0,2 (2ct 0st),2.000,
Mohsin Kamal (PAK),1984-1994,9,15,4,4,0,0,4,1 (1ct 0st),0.266,
LJ Moon (ENG),1906-1906,4,7,4,4,0,1,3,2 (2ct 0st),0.571,
F Morley (ENG),1880-1883,4,8,4,4,0,0,4,2 (2ct 0st),0.500,
CB Mpofu (ZIM),2005-2017,15,24,4,4,0,0,4,1 (1ct 0st),0.166,
TK Musakanda (ZIM),2017-2021,5,8,4,4,0,0,4,2 (2ct 0st),0.500,
Naimur Rahman (BAN),2000-2002,8,11,4,4,0,0,4,2 (2ct 0st),0.363,
Nasir Jamal (AFG),2019-2023,3,6,4,4,0,0,4,2 (2ct 0st),0.666,
CK Nayudu (IND),1932-1936,7,13,4,4,0,0,4,1 (1ct 0st),0.307,
ML Nkala (ZIM),2000-2005,10,17,4,4,0,0,4,2 (2ct 0st),0.235,
Sir TC O'Brien (ENG),1884-1896,5,9,4,4,0,0,4,1 (1ct 0st),0.444,
SP O'Donnell (AUS),1985-1985,6,10,4,4,0,0,4,2 (2ct 0st),0.400,
S O'Linn (SA),1960-1961,7,13,4,4,0,0,4,2 (2ct 0st),0.307,
HGO Owen-Smith (SA),1929-1929,5,9,4,4,0,0,4,2 (2ct 0st),0.444,
RK Oxenham (AUS),1928-1931,7,14,4,4,0,0,4,1 (1ct 0st),0.285,
DR Parry (WI),1978-1980,12,21,4,4,0,0,4,1 (1ct 0st),0.190,
CT Patankar (IND),1955-1956,1,2,4,3,1,3,0,4 (3ct 1st),2.000,
CE Pellew (AUS),1920-1921,10,20,4,4,0,0,4,1 (1ct 0st),0.200,
V Permaul (WI),2012-2022,9,17,4,4,0,0,4,1 (1ct 0st),0.235,
PJ Petherick (NZ),1976-1977,6,12,4,4,0,0,4,2 (2ct 0st),0.333,
WR Playle (NZ),1958-1963,8,10,4,4,0,0,4,1 (1ct 0st),0.400,
RW Price (ZIM),1999-2013,22,37,4,4,0,0,4,2 (2ct 0st),0.108,
MJ Procter (SA),1967-1970,7,14,4,4,0,0,4,2 (2ct 0st),0.285,
WG Quaife (ENG),1899-1902,7,14,4,4,0,0,4,2 (2ct 0st),0.285,
CT Radley (ENG),1978-1978,8,15,4,4,0,0,4,1 (1ct 0st),0.266,
Rahmat Shah (AFG),2018-2023,7,13,4,4,0,0,4,1 (1ct 0st),0.307,
V Rajindernath (IND),1952-1952,1,2,4,0,4,0,0,2 (0ct 2st),2.000,
AU Rashid (ENG),2015-2019,19,36,4,4,0,0,4,1 (1ct 0st),0.111,
DM Richards (WI),2009-2010,3,6,4,4,0,0,4,1 (1ct 0st),0.666,
Rizwan-uz-Zaman (PAK),1981-1989,11,19,4,4,0,0,4,1 (1ct 0st),0.210,
ADG Roberts (NZ),1976-1976,7,14,4,4,0,0,4,1 (1ct 0st),0.285,
AW Roberts (NZ),1930-1937,5,9,4,4,0,0,4,1 (1ct 0st),0.444,
RD Robinson (AUS),1977-1977,3,5,4,4,0,0,4,1 (1ct 0st),0.800,
BC Rose (ENG),1977-1981,9,13,4,4,0,0,4,2 (2ct 0st),0.307,
FA Rose (WI),1997-2000,19,33,4,4,0,0,4,2 (2ct 0st),0.121,
GA Rowe (SA),1896-1902,5,8,4,4,0,0,4,2 (2ct 0st),0.500,
WE Russell (ENG),1961-1967,10,18,4,4,0,0,4,2 (2ct 0st),0.222,
Sajid Khan (PAK),2021-2022,7,13,4,4,0,0,4,1 (1ct 0st),0.307,
A Sandham (ENG),1921-1930,14,24,4,4,0,0,4,1 (1ct 0st),0.166,
A Sanford (WI),2002-2004,11,19,4,4,0,0,4,2 (2ct 0st),0.210,
DN Sardesai (IND),1961-1972,30,55,4,4,0,0,4,1 (1ct 0st),0.072,
WH Scotton (ENG),1881-1887,15,28,4,4,0,0,4,2 (2ct 0st),0.142,
Shakeel Ahmed jnr (PAK),1993-1995,3,6,4,4,0,0,4,2 (2ct 0st),0.666,
MD Shanaka (SL),2016-2021,6,9,4,4,0,0,4,2 (2ct 0st),0.444,
A Shaw (ENG),1877-1882,7,13,4,4,0,0,4,2 (2ct 0st),0.307,
JN Shepherd (WI),1969-1971,5,10,4,4,0,0,4,2 (2ct 0st),0.400,
MW Sievers (AUS),1936-1937,3,5,4,4,0,0,4,2 (2ct 0st),0.800,
PR Sleep (AUS),1979-1990,14,23,4,4,0,0,4,1 (1ct 0st),0.173,
RH Spooner (ENG),1905-1912,10,18,4,4,0,0,4,1 (1ct 0st),0.222,
PR Stirling (IRE),2018-2023,5,9,4,4,0,0,4,2 (2ct 0st),0.444,
PM Such (ENG),1993-1999,11,20,4,4,0,0,4,2 (2ct 0st),0.200,
Surendra Nath (IND),1958-1961,11,17,4,4,0,0,4,2 (2ct 0st),0.235,
Talat Ali (PAK),1972-1979,10,16,4,4,0,0,4,1 (1ct 0st),0.250,
DJ Terbrugge (SA),1998-2004,7,14,4,4,0,0,4,1 (1ct 0st),0.285,
ERH Toshack (AUS),1946-1948,12,24,4,4,0,0,4,1 (1ct 0st),0.166,
CT Tremlett (ENG),2007-2013,12,24,4,4,0,0,4,1 (1ct 0st),0.166,
AE Trott (AUS/ENG),1895-1899,5,10,4,4,0,0,4,3 (3ct 0st),0.400,
FH Tyson (ENG),1954-1959,17,32,4,4,0,0,4,1 (1ct 0st),0.125,
JTC Vaughan (NZ),1992-1997,6,9,4,4,0,0,4,2 (2ct 0st),0.444,
GH Vihari (IND),2018-2022,16,32,4,4,0,0,4,1 (1ct 0st),0.125,
HG Vivian (NZ),1931-1937,7,11,4,4,0,0,4,1 (1ct 0st),0.363,
HF Wade (SA),1935-1936,10,15,4,4,0,0,4,1 (1ct 0st),0.266,
W Watson (NZ),1986-1993,15,26,4,4,0,0,4,1 (1ct 0st),0.153,
WJ Whitty (AUS),1909-1912,14,25,4,4,0,0,4,1 (1ct 0st),0.160,
JM Wiener (AUS),1979-1980,6,10,4,4,0,0,4,2 (2ct 0st),0.400,
BA Williams (AUS),2003-2004,4,8,4,4,0,0,4,2 (2ct 0st),0.500,
LB Williams (SA),2022-2022,2,4,4,4,0,0,4,2 (2ct 0st),1.000,
DNT Zoysa (SL),1997-2004,30,51,4,4,0,0,4,1 (1ct 0st),0.078,
JW Zulch (SA),1910-1921,16,30,4,4,0,0,4,1 (1ct 0st),0.133,
Zulfiqar Babar (PAK),2013-2016,15,28,4,4,0,0,4,1 (1ct 0st),0.142,
Abul Hasan (BAN),2012-2013,3,6,3,3,0,0,3,2 (2ct 0st),0.500,
Aftab Gul (PAK),1969-1971,6,11,3,3,0,0,3,1 (1ct 0st),0.272,
Agha Saadat Ali (PAK),1955-1955,1,2,3,3,0,0,3,2 (2ct 0st),1.500,
Ahmed Shehzad (PAK),2013-2017,13,26,3,3,0,0,3,1 (1ct 0st),0.115,
Akram Khan (BAN),2000-2003,8,11,3,3,0,0,3,1 (1ct 0st),0.272,
CFW Allcott (NZ),1930-1932,6,9,3,3,0,0,3,1 (1ct 0st),0.333,
L Amar Singh (IND),1932-1936,7,13,3,3,0,0,3,1 (1ct 0st),0.230,
AMJG Amerasinghe (SL),1984-1984,2,3,3,3,0,0,3,2 (2ct 0st),1.000,
BJ Arnel (NZ),2010-2012,6,12,3,3,0,0,3,1 (1ct 0st),0.250,
TD Astle (NZ),2012-2020,5,10,3,3,0,0,3,1 (1ct 0st),0.300,
RA Austin (WI),2009-2009,2,4,3,3,0,0,3,2 (2ct 0st),0.750,
KBJ Azad (IND),1981-1983,7,14,3,3,0,0,3,1 (1ct 0st),0.214,
CL Badcock (AUS),1936-1938,7,11,3,3,0,0,3,1 (1ct 0st),0.272,
AH Bakewell (ENG),1931-1935,6,12,3,3,0,0,3,2 (2ct 0st),0.250,
SA Banerjee (IND),1948-1949,1,2,3,3,0,0,3,2 (2ct 0st),1.500,
GJ Batty (ENG),2003-2016,9,16,3,3,0,0,3,2 (2ct 0st),0.187,
DM Bess (ENG),2018-2021,14,26,3,3,0,0,3,1 (1ct 0st),0.115,
GP Bilby (NZ),1966-1966,2,3,3,3,0,0,3,1 (1ct 0st),1.000,
J Birkenshaw (ENG),1973-1974,5,9,3,3,0,0,3,2 (2ct 0st),0.333,
M Bisset (SA),1899-1910,3,6,3,2,1,2,0,1 (1ct 0st),0.500,
J Botha (SA),2006-2010,5,10,3,3,0,0,3,1 (1ct 0st),0.300,
IDR Bradshaw (WI),2006-2006,5,7,3,3,0,0,3,2 (2ct 0st),0.428,
VR Brown (NZ),1985-1985,2,4,3,3,0,0,3,2 (2ct 0st),0.750,
RO Butcher (ENG),1981-1981,3,4,3,3,0,0,3,2 (2ct 0st),0.750,
Hon.FSG Calthorpe (ENG),1930-1930,4,8,3,3,0,0,3,1 (1ct 0st),0.375,
PR Carlstein (SA),1958-1964,8,15,3,3,0,0,3,1 (1ct 0st),0.200,
AW Carr (ENG),1922-1929,11,16,3,3,0,0,3,1 (1ct 0st),0.187,
JAJ Christy (SA),1929-1932,10,17,3,3,0,0,3,1 (1ct 0st),0.176,
CK Coventry (ZIM),2005-2005,2,3,3,3,0,0,3,2 (2ct 0st),1.000,
J Cowie (NZ),1937-1949,9,14,3,3,0,0,3,2 (2ct 0st),0.214,
K Cranston (ENG),1947-1948,8,16,3,3,0,0,3,2 (2ct 0st),0.187,
RJ Crisp (SA),1935-1936,9,14,3,3,0,0,3,1 (1ct 0st),0.214,
CD Cumming (NZ),2005-2008,11,20,3,3,0,0,3,1 (1ct 0st),0.150,
TS Curtis (ENG),1988-1989,5,9,3,3,0,0,3,1 (1ct 0st),0.333,
RKJ Dawson (ENG),2001-2003,7,11,3,3,0,0,3,2 (2ct 0st),0.272,
JH de Courcy (AUS),1953-1953,3,5,3,3,0,0,3,2 (2ct 0st),0.600,
GR Dickinson (NZ),1930-1932,3,6,3,3,0,0,3,2 (2ct 0st),0.500,
GHG Doggart (ENG),1950-1950,2,4,3,3,0,0,3,1 (1ct 0st),0.750,
B Dooland (AUS),1947-1948,3,6,3,3,0,0,3,1 (1ct 0st),0.500,
UG Dowe (WI),1971-1973,4,8,3,3,0,0,3,1 (1ct 0st),0.375,
A D'Souza (PAK),1959-1962,6,10,3,3,0,0,3,2 (2ct 0st),0.300,
CAR Duckworth (SA),1957-1957,2,4,3,3,0,0,3,1 (1ct 0st),0.750,
R Dumbrill (SA),1965-1967,5,10,3,3,0,0,3,1 (1ct 0st),0.300,
Enamul Haque jnr (BAN),2003-2013,15,27,3,3,0,0,3,1 (1ct 0st),0.111,
Fakhar Zaman (PAK),2018-2019,3,6,3,3,0,0,3,1 (1ct 0st),0.500,
MVT Fernando (SL),2016-2023,20,35,3,3,0,0,3,1 (1ct 0st),0.085,
MLC Foster (WI),1969-1978,14,26,3,3,0,0,3,1 (1ct 0st),0.115,
ERH Fuller (SA),1953-1958,7,12,3,3,0,0,3,1 (1ct 0st),0.250,
DJ Gandhi (IND),1999-1999,4,8,3,3,0,0,3,1 (1ct 0st),0.375,
JB Gannon (AUS),1977-1978,3,5,3,3,0,0,3,2 (2ct 0st),0.600,
AER Gilligan (ENG),1922-1925,11,21,3,3,0,0,3,1 (1ct 0st),0.142,
TWJ Goddard (ENG),1930-1939,8,13,3,3,0,0,3,1 (1ct 0st),0.230,
MJ Gopalan (IND),1934-1934,1,2,3,3,0,0,3,2 (2ct 0st),1.500,
H Graham (AUS),1893-1896,6,11,3,3,0,0,3,1 (1ct 0st),0.272,
GA Greenidge (WI),1972-1973,5,9,3,3,0,0,3,1 (1ct 0st),0.333,
Gul Mohammad (IND/PAK),1946-1956,9,13,3,3,0,0,3,1 (1ct 0st),0.230,
JR Gunn (ENG),1901-1905,6,12,3,3,0,0,3,1 (1ct 0st),0.250,
PAM Hands (SA),1913-1924,7,10,3,3,0,0,3,2 (2ct 0st),0.300,
MS Hardikar (IND),1958-1958,2,4,3,3,0,0,3,2 (2ct 0st),0.750,
NM Hauritz (AUS),2004-2010,17,33,3,3,0,0,3,1 (1ct 0st),0.090,
Lord Hawke (ENG),1896-1899,5,10,3,3,0,0,3,2 (2ct 0st),0.300,
JA Hayes (NZ),1951-1958,15,20,3,3,0,0,3,2 (2ct 0st),0.150,
F Hearne (ENG/SA),1889-1896,6,9,3,3,0,0,3,1 (1ct 0st),0.333,
GAL Hearne (SA),1922-1924,3,5,3,3,0,0,3,3 (3ct 0st),0.600,
C Heseltine (ENG),1896-1896,2,4,3,3,0,0,3,1 (1ct 0st),0.750,
JD Higgs (AUS),1978-1981,22,39,3,3,0,0,3,1 (1ct 0st),0.076,
DD Hindlekar (IND),1936-1946,4,7,3,3,0,3,0,1 (1ct 0st),0.428,
TV Hohns (AUS),1989-1989,7,13,3,3,0,0,3,1 (1ct 0st),0.230,
P Holmes (ENG),1921-1932,7,14,3,3,0,0,3,2 (2ct 0st),0.214,
KA Hope (WI),2017-2017,5,9,3,3,0,0,3,1 (1ct 0st),0.333,
PA Horne (NZ),1987-1990,4,7,3,3,0,0,3,1 (1ct 0st),0.428,
AG Huckle (ZIM),1997-1998,8,14,3,3,0,0,3,1 (1ct 0st),0.214,
AG Hurst (AUS),1974-1979,12,22,3,3,0,0,3,1 (1ct 0st),0.136,
P Hutchinson (SA),1889-1889,2,3,3,3,0,0,3,2 (2ct 0st),1.000,
Ijaz Ahmed jnr (PAK),1995-1995,2,4,3,3,0,0,3,2 (2ct 0st),0.750,
JK Irani (IND),1947-1947,2,2,3,2,1,2,0,2 (1ct 1st),1.500,
H Ironmonger (AUS),1928-1933,14,28,3,3,0,0,3,2 (2ct 0st),0.107,
KM Jarvis (ZIM),2011-2020,13,23,3,3,0,0,3,1 (1ct 0st),0.130,
TW Jarvis (NZ),1965-1973,13,24,3,3,0,0,3,2 (2ct 0st),0.125,
JNT Seales (WI),2021-2022,10,19,3,3,0,0,3,1 (1ct 0st),0.157,
CEL Jones (WI),1930-1935,4,8,3,3,0,0,3,2 (2ct 0st),0.375,
SC Joseph (WI),2004-2007,5,9,3,3,0,0,3,1 (1ct 0st),0.333,
KT Kasuza (ZIM),2020-2021,7,11,3,3,0,0,3,1 (1ct 0st),0.272,
PHT Kaushal (SL),2014-2015,7,14,3,3,0,0,3,2 (2ct 0st),0.214,
JM Kemp (SA),2001-2005,4,8,3,3,0,0,3,1 (1ct 0st),0.375,
Khalid Ibadulla (PAK),1964-1967,4,8,3,3,0,0,3,2 (2ct 0st),0.375,
RJ Kirtley (ENG),2003-2003,4,7,3,3,0,0,3,1 (1ct 0st),0.428,
JJ Kotze (SA),1902-1907,3,5,3,3,0,0,3,1 (1ct 0st),0.600,
Kuldeep Yadav (IND),2017-2022,8,15,3,3,0,0,3,1 (1ct 0st),0.200,
GF Labrooy (SL),1986-1991,9,15,3,3,0,0,3,1 (1ct 0st),0.200,
TJ Laughlin (AUS),1978-1978,3,6,3,3,0,0,3,2 (2ct 0st),0.500,
DW Lawrence (ENG),2021-2022,11,21,3,3,0,0,3,1 (1ct 0st),0.142,
JJC Lawson (WI),2002-2005,13,26,3,3,0,0,3,1 (1ct 0st),0.115,
E Leadbeater (ENG),1951-1952,2,4,3,3,0,0,3,2 (2ct 0st),0.750,
WHV Levett (ENG),1934-1934,1,2,3,3,0,3,0,3 (3ct 0st),1.500,
HSB Love (AUS),1933-1933,1,2,3,3,0,3,0,3 (3ct 0st),1.500,
JJ Lyons (AUS),1887-1897,14,25,3,3,0,0,3,1 (1ct 0st),0.120,
EA McDonald (AUS),1921-1921,11,22,3,3,0,0,3,1 (1ct 0st),0.136,
A McGrath (ENG),2003-2003,4,7,3,3,0,0,3,1 (1ct 0st),0.428,
RW McLeod (AUS),1892-1893,6,10,3,3,0,0,3,1 (1ct 0st),0.300,
ES Maka (IND),1952-1953,2,3,3,2,1,2,0,3 (2ct 1st),1.000,
PJ Malan (SA),2020-2020,3,5,3,3,0,0,3,1 (1ct 0st),0.600,
FG Mann (ENG),1948-1949,7,13,3,3,0,0,3,2 (2ct 0st),0.230,
NBF Mann (SA),1947-1951,19,34,3,3,0,0,3,1 (1ct 0st),0.088,
GA Manou (AUS),2009-2009,1,1,3,3,0,3,0,3 (3ct 0st),3.000,
Manjural Islam Rana (BAN),2004-2004,6,7,3,3,0,0,3,2 (2ct 0st),0.428,
WP Masakadza (ZIM),2018-2023,3,5,3,3,0,0,3,1 (1ct 0st),0.600,
JR Mason (ENG),1897-1898,5,8,3,3,0,0,3,1 (1ct 0st),0.375,
EH Mattis (WI),1981-1981,4,8,3,3,0,0,3,2 (2ct 0st),0.375,
MP Maynard (ENG),1988-1994,4,8,3,3,0,0,3,1 (1ct 0st),0.375,
LC Mayne (AUS),1965-1970,6,12,3,3,0,0,3,1 (1ct 0st),0.250,
DJ Meintjes (SA),1923-1923,2,4,3,3,0,0,3,2 (2ct 0st),0.750,
RS Modi (IND),1946-1952,10,16,3,3,0,0,3,1 (1ct 0st),0.187,
Mohammad Asif (PAK),2005-2010,23,45,3,3,0,0,3,1 (1ct 0st),0.066,
Mohammad Salman (PAK),2011-2011,2,4,3,2,1,2,0,1 (1ct 0st),0.750,
DAR Moloney (NZ),1937-1937,3,6,3,3,0,0,3,2 (2ct 0st),0.500,
H Morris (ENG),1991-1991,3,6,3,3,0,0,3,1 (1ct 0st),0.500,
JE Morris (ENG),1990-1990,3,5,3,3,0,0,3,2 (2ct 0st),0.600,
JB Mortimore (ENG),1959-1964,9,17,3,3,0,0,3,1 (1ct 0st),0.176,
S Moseley (WI),2021-2021,2,4,3,3,0,0,3,2 (2ct 0st),0.750,
ARA Murray (SA),1952-1954,10,18,3,3,0,0,3,1 (1ct 0st),0.166,
S Muthusamy (SA),2019-2023,3,5,3,3,0,0,3,2 (2ct 0st),0.600,
D Myers (ZIM),2021-2021,1,2,3,3,0,0,3,2 (2ct 0st),1.500,
Naved-ul-Hasan (PAK),2004-2007,9,17,3,3,0,0,3,2 (2ct 0st),0.176,
CS Nayudu (IND),1934-1952,11,17,3,3,0,0,3,1 (1ct 0st),0.176,
C Newberry (SA),1913-1914,4,7,3,3,0,0,3,3 (3ct 0st),0.428,
ES Newson (SA),1930-1939,3,6,3,3,0,0,3,2 (2ct 0st),0.500,
F Nicholson (SA),1935-1936,4,6,3,3,0,3,0,2 (2ct 0st),0.500,
P Nissanka (SL),2021-2022,9,17,3,3,0,0,3,1 (1ct 0st),0.176,
HC Nitschke (AUS),1931-1931,2,4,3,3,0,0,3,1 (1ct 0st),0.750,
VM Nyauchi (ZIM),2020-2023,8,14,3,3,0,0,3,1 (1ct 0st),0.214,
LPJ O'Brien (AUS),1932-1936,5,9,3,3,0,0,3,2 (2ct 0st),0.333,
JDA O'Connor (AUS),1908-1909,4,8,3,3,0,0,3,1 (1ct 0st),0.375,
D Olivier (SA),2017-2022,15,29,3,3,0,0,3,1 (1ct 0st),0.103,
MB Owens (NZ),1992-1994,8,12,3,3,0,0,3,2 (2ct 0st),0.250,
T Panyangara (ZIM),2004-2014,9,16,3,3,0,0,3,2 (2ct 0st),0.187,
WGA Parkhouse (ENG),1950-1959,7,13,3,3,0,0,3,1 (1ct 0st),0.230,
CH Parkin (ENG),1920-1924,10,17,3,3,0,0,3,2 (2ct 0st),0.176,
WD Parnell (SA),2010-2017,6,11,3,3,0,0,3,1 (1ct 0st),0.272,
CC Passailaigue (WI),1930-1930,1,2,3,3,0,0,3,2 (2ct 0st),1.500,
AR Patel (IND),2021-2023,12,24,3,3,0,0,3,1 (1ct 0st),0.125,
SR Patel (ENG),2012-2015,6,12,3,3,0,0,3,1 (1ct 0st),0.250,
AJ Pithey (SA),1957-1965,17,32,3,3,0,0,3,1 (1ct 0st),0.093,
LE Plunkett (ENG),2005-2014,13,25,3,3,0,0,3,1 (1ct 0st),0.120,
R Pollard (ENG),1946-1948,4,7,3,3,0,0,3,1 (1ct 0st),0.428,
RM Poore (SA),1896-1896,3,4,3,3,0,0,3,2 (2ct 0st),0.750,
SW Poynter (IRE),2019-2019,1,2,3,2,1,2,0,2 (1ct 1st),1.500,
C Pringle (NZ),1990-1995,14,24,3,3,0,0,3,1 (1ct 0st),0.125,
R Rampaul (WI),2009-2012,18,34,3,3,0,0,3,1 (1ct 0st),0.088,
BA Richards (SA),1970-1970,4,8,3,3,0,0,3,1 (1ct 0st),0.375,
F Ridgway (ENG),1951-1952,5,8,3,3,0,0,3,2 (2ct 0st),0.375,
WV Rodriguez (WI),1962-1968,5,10,3,3,0,0,3,2 (2ct 0st),0.300,
Sabbir Rahman (BAN),2016-2018,11,21,3,3,0,0,3,2 (2ct 0st),0.142,
Salahuddin (PAK),1965-1969,5,9,3,3,0,0,3,1 (1ct 0st),0.333,
Saleem Altaf (PAK),1967-1978,21,41,3,3,0,0,3,1 (1ct 0st),0.073,
MAR Samarasekera (SL),1988-1991,4,6,3,3,0,0,3,2 (2ct 0st),0.500,
Shabbir Ahmed (PAK),2003-2005,10,19,3,3,0,0,3,1 (1ct 0st),0.157,
Shadab Khan (PAK),2017-2020,6,11,3,3,0,0,3,1 (1ct 0st),0.272,
WA Shalders (SA),1899-1907,12,23,3,3,0,0,3,1 (1ct 0st),0.130,
TAM Siriwardana (SL),2015-2016,5,10,3,3,0,0,3,1 (1ct 0st),0.300,
WN Slack (ENG),1986-1986,3,6,3,3,0,0,3,1 (1ct 0st),0.500,
JA Small (WI),1928-1930,3,4,3,3,0,0,3,2 (2ct 0st),0.750,
VI Smith (SA),1947-1957,9,16,3,3,0,0,3,1 (1ct 0st),0.187,
JT Sparling (NZ),1958-1964,11,16,3,3,0,0,3,1 (1ct 0st),0.187,
LA Stricker (SA),1910-1912,13,24,3,3,0,0,3,1 (1ct 0st),0.125,
Tahir Naqqash (PAK),1982-1985,15,27,3,3,0,0,3,1 (1ct 0st),0.111,
LJ Tancred (SA),1902-1913,14,26,3,3,0,0,3,1 (1ct 0st),0.115,
G Thomas (AUS),1965-1966,8,15,3,3,0,0,3,1 (1ct 0st),0.200,
NFD Thomson (AUS),1877-1877,2,4,3,3,0,0,3,2 (2ct 0st),0.750,
NI Thomson (ENG),1964-1965,5,10,3,3,0,0,3,1 (1ct 0st),0.300,
T Thushara (SL),2003-2010,10,18,3,3,0,0,3,2 (2ct 0st),0.166,
JW Trumble (AUS),1885-1886,7,11,3,3,0,0,3,2 (2ct 0st),0.272,
AJ Tudor (ENG),1998-2002,10,17,3,3,0,0,3,2 (2ct 0st),0.176,
JD Unadkat (IND),2010-2023,4,7,3,3,0,0,3,1 (1ct 0st),0.428,
EA van der Merwe (SA),1929-1936,2,3,3,3,0,3,0,2 (2ct 0st),1.000,
R Vijay Bharadwaj (IND),1999-2000,3,5,3,3,0,0,3,2 (2ct 0st),0.600,
GE Vivian (NZ),1965-1972,5,10,3,3,0,0,3,1 (1ct 0st),0.300,
KA Walter (SA),1961-1961,2,4,3,3,0,0,3,1 (1ct 0st),0.750,
A Ward (ENG),1969-1976,5,9,3,3,0,0,3,2 (2ct 0st),0.333,
PF Warner (ENG),1899-1912,15,28,3,3,0,0,3,2 (2ct 0st),0.107,
DM Washington (WI),2005-2005,1,2,3,3,0,0,3,2 (2ct 0st),1.500,
GL Weir (NZ),1930-1937,11,16,3,3,0,0,3,1 (1ct 0st),0.187,
P Willey (ENG),1976-1986,26,44,3,3,0,0,3,1 (1ct 0st),0.068,
H Wood (ENG),1888-1892,4,8,3,2,1,2,0,2 (1ct 1st),0.375,
OE Wynne (SA),1948-1950,6,10,3,3,0,0,3,2 (2ct 0st),0.300,
J Yadav (IND),2016-2022,6,12,3,3,0,0,3,1 (1ct 0st),0.250,
V Yadav (IND),1993-1993,1,2,3,1,2,1,0,2 (0ct 2st),1.500,
Aamer Nazir (PAK),1993-1995,6,12,2,2,0,0,2,2 (2ct 0st),0.166,
Aaqib Javed (PAK),1989-1998,22,38,2,2,0,0,2,1 (1ct 0st),0.052,
Abrar Ahmed (PAK),2022-2023,6,12,2,2,0,0,2,1 (1ct 0st),0.166,
MR Adair (IRE),2019-2023,4,7,2,2,0,0,2,1 (1ct 0st),0.285,
Afaq Hussain (PAK),1961-1964,2,4,2,2,0,0,2,1 (1ct 0st),0.500,
G Alexander (AUS),1880-1884,2,4,2,2,0,0,2,1 (1ct 0st),0.500,
RC Allen (AUS),1887-1887,1,2,2,2,0,0,2,2 (2ct 0st),1.000,
GI Allott (NZ),1996-1999,10,16,2,2,0,0,2,1 (1ct 0st),0.125,
SW Ambris (WI),2017-2018,6,9,2,2,0,0,2,1 (1ct 0st),0.222,
Amir Hamza (AFG),2019-2023,4,8,2,2,0,0,2,1 (1ct 0st),0.250,
Anamul Haque (BAN),2013-2022,5,9,2,2,0,0,2,1 (1ct 0st),0.222,
ML Apte (IND),1952-1953,7,12,2,2,0,0,2,1 (1ct 0st),0.166,
JC Archer (ENG),2019-2021,13,25,2,2,0,0,2,1 (1ct 0st),0.080,
Ariful Haque (BAN),2018-2018,2,4,2,2,0,0,2,1 (1ct 0st),0.500,
Arshad Ayub (IND),1987-1989,13,24,2,2,0,0,2,1 (1ct 0st),0.083,
B Arun (IND),1986-1987,2,3,2,2,0,0,2,1 (1ct 0st),0.666,
Asghar Afghan (AFG),2018-2021,6,11,2,2,0,0,2,1 (1ct 0st),0.181,
Ata-ur-Rehman (PAK),1992-1996,13,23,2,2,0,0,2,1 (1ct 0st),0.086,
A Athanaze (WI),2023-2023,2,3,2,2,0,0,2,2 (2ct 0st),0.666,
ES Atkinson (WI),1958-1959,8,15,2,2,0,0,2,1 (1ct 0st),0.133,
RA Austin (WI),1978-1978,2,4,2,2,0,0,2,1 (1ct 0st),0.500,
S Badrinath (IND),2010-2010,2,3,2,2,0,0,2,1 (1ct 0st),0.666,
L Baichan (WI),1975-1976,3,6,2,2,0,0,2,2 (2ct 0st),0.333,
EAE Baptiste (WI),1983-1990,10,20,2,2,0,0,2,1 (1ct 0st),0.100,
F Barratt (ENG),1929-1930,5,8,2,2,0,0,2,1 (1ct 0st),0.250,
EL Bartlett (WI),1928-1931,5,7,2,2,0,0,2,1 (1ct 0st),0.285,
Bazid Khan (PAK),2005-2005,1,2,2,2,0,0,2,2 (2ct 0st),1.000,
DD Beard (NZ),1952-1956,4,7,2,2,0,0,2,2 (2ct 0st),0.285,
R Beaumont (SA),1912-1914,5,7,2,2,0,0,2,1 (1ct 0st),0.285,
DW Begbie (SA),1948-1950,5,8,2,2,0,0,2,1 (1ct 0st),0.250,
KCG Benjamin (WI),1992-1998,26,50,2,2,0,0,2,1 (1ct 0st),0.040,
R Berry (ENG),1950-1950,2,4,2,2,0,0,2,2 (2ct 0st),0.500,
MP Bicknell (ENG),1993-2003,4,7,2,2,0,0,2,1 (1ct 0st),0.285,
Bilal Asif (PAK),2018-2018,5,10,2,2,0,0,2,2 (2ct 0st),0.200,
JM Bird (AUS),2012-2017,9,17,2,2,0,0,2,1 (1ct 0st),0.117,
DD Blackie (AUS),1928-1929,3,6,2,2,0,0,2,2 (2ct 0st),0.333,
RJ Blakey (ENG),1993-1993,2,2,2,2,0,2,0,1 (1ct 0st),1.000,
DE Bollinger (AUS),2009-2010,12,23,2,2,0,0,2,1 (1ct 0st),0.086,
JB Bolus (ENG),1963-1964,7,14,2,2,0,0,2,1 (1ct 0st),0.142,
SG Borthwick (ENG),2014-2014,1,2,2,2,0,0,2,2 (2ct 0st),1.000,
WE Bowes (ENG),1932-1946,15,29,2,2,0,0,2,1 (1ct 0st),0.068,
EH Bowley (ENG),1929-1930,5,8,2,2,0,0,2,1 (1ct 0st),0.250,
NW Bracken (AUS),2003-2005,5,10,2,2,0,0,2,1 (1ct 0st),0.200,
WP Bradburn (NZ),1964-1964,2,4,2,2,0,0,2,1 (1ct 0st),0.500,
WH Brann (SA),1922-1923,3,6,2,2,0,0,2,1 (1ct 0st),0.333,
EH Bromley (AUS),1933-1934,2,3,2,2,0,0,2,1 (1ct 0st),0.666,
CP Buckenham (ENG),1910-1910,4,8,2,2,0,0,2,1 (1ct 0st),0.250,
FJ Burton (AUS),1887-1888,2,4,2,1,1,0,1,1 (1ct 0st),0.500,
TB Burtt (NZ),1947-1953,10,14,2,2,0,0,2,1 (1ct 0st),0.142,
HR Butt (ENG),1896-1896,3,6,2,1,1,1,0,1 (1ct 0st),0.333,
CG Butts (WI),1985-1988,7,12,2,2,0,0,2,1 (1ct 0st),0.166,
FJ Cameron (NZ),1961-1965,19,35,2,2,0,0,2,1 (1ct 0st),0.057,
J Cameron-Dow (IRE),2019-2019,1,2,2,2,0,0,2,2 (2ct 0st),1.000,
PH Carlson (AUS),1979-1979,2,4,2,2,0,0,2,1 (1ct 0st),0.500,
CP Carter (SA),1912-1924,10,16,2,2,0,0,2,1 (1ct 0st),0.125,
TW Cartwright (ENG),1964-1965,5,9,2,2,0,0,2,2 (2ct 0st),0.222,
B Casson (AUS),2008-2008,1,2,2,2,0,0,2,2 (2ct 0st),1.000,
R Chandrika (WI),2015-2016,5,7,2,2,0,0,2,2 (2ct 0st),0.285,
TM Chappell (AUS),1981-1981,3,6,2,2,0,0,2,1 (1ct 0st),0.333,
ST Clarke (WI),1978-1982,11,19,2,2,0,0,2,1 (1ct 0st),0.105,
SHM Colah (IND),1932-1933,2,4,2,2,0,0,2,2 (2ct 0st),0.500,
JB Commins (SA),1994-1995,3,6,2,2,0,0,2,1 (1ct 0st),0.333,
M Commins (IRE),2023-2023,2,3,2,2,0,0,2,1 (1ct 0st),0.666,
BB Cooper (AUS),1877-1877,1,2,2,2,0,0,2,2 (2ct 0st),1.000,
TA Copeland (AUS),2011-2011,3,6,2,2,0,0,2,1 (1ct 0st),0.333,
RMH Cottam (ENG),1969-1973,4,8,2,2,0,0,2,1 (1ct 0st),0.250,
ID Craig (AUS),1953-1958,11,20,2,2,0,0,2,1 (1ct 0st),0.100,
ML Cummins (WI),2016-2019,14,23,2,2,0,0,2,1 (1ct 0st),0.086,
WR Cuttell (ENG),1899-1899,2,4,2,2,0,0,2,2 (2ct 0st),0.500,
LA Dawson (ENG),2016-2017,3,5,2,2,0,0,2,2 (2ct 0st),0.400,
H Dean (ENG),1912-1912,3,5,2,2,0,0,2,1 (1ct 0st),0.400,
CS Dempster (NZ),1930-1933,10,15,2,2,0,0,2,1 (1ct 0st),0.133,
PWH de Silva (SL),2020-2021,4,7,2,2,0,0,2,1 (1ct 0st),0.285,
T de Zorzi (SA),2023-2023,2,4,2,2,0,0,2,2 (2ct 0st),0.500,
XJ Doherty (AUS),2010-2013,4,6,2,2,0,0,2,2 (2ct 0st),0.333,
H Donnan (AUS),1892-1896,5,9,2,2,0,0,2,1 (1ct 0st),0.222,
RR Dower (SA),1899-1899,1,2,2,2,0,0,2,1 (1ct 0st),1.000,
VC Drakes (WI),2002-2004,12,23,2,2,0,0,2,1 (1ct 0st),0.086,
JP Duminy (SA),1927-1929,3,6,2,2,0,0,2,1 (1ct 0st),0.333,
JA Dunning (NZ),1933-1937,4,7,2,2,0,0,2,1 (1ct 0st),0.285,
JH du Preez (SA),1967-1967,2,4,2,2,0,0,2,1 (1ct 0st),0.500,
CJ Eady (AUS),1896-1902,2,4,2,2,0,0,2,1 (1ct 0st),0.500,
Ehteshamuddin (PAK),1979-1982,5,8,2,2,0,0,2,1 (1ct 0st),0.250,
GD Elliott (NZ),2008-2009,5,9,2,2,0,0,2,2 (2ct 0st),0.222,
RM Ellison (ENG),1984-1986,11,22,2,2,0,0,2,1 (1ct 0st),0.090,
L Embuldeniya (SL),2019-2022,17,31,2,2,0,0,2,1 (1ct 0st),0.064,
SH Emery (AUS),1912-1912,4,5,2,2,0,0,2,1 (1ct 0st),0.400,
WS Farrer (SA),1962-1964,6,12,2,2,0,0,2,1 (1ct 0st),0.166,
Fazl-e-Akbar (PAK),1998-2004,5,8,2,2,0,0,2,1 (1ct 0st),0.250,
JP Fellows-Smith (SA),1960-1960,4,7,2,2,0,0,2,1 (1ct 0st),0.285,
AM Fernando (SL),2021-2023,12,21,2,2,0,0,2,1 (1ct 0st),0.095,
CG Fichardt (SA),1892-1896,2,3,2,2,0,0,2,1 (1ct 0st),0.666,
W Flowers (ENG),1884-1893,8,15,2,2,0,0,2,1 (1ct 0st),0.133,
TJ Friend (ZIM),2001-2004,13,19,2,2,0,0,2,1 (1ct 0st),0.105,
LV Garrick (WI),2001-2001,1,2,2,2,0,0,2,1 (1ct 0st),1.000,
C Gladwin (ENG),1947-1949,8,15,2,2,0,0,2,1 (1ct 0st),0.133,
RA Gleeson (SA),1896-1896,1,2,2,2,0,0,2,1 (1ct 0st),1.000,
CD Gopinath (IND),1951-1960,8,14,2,2,0,0,2,1 (1ct 0st),0.142,
GF Grace (ENG),1880-1880,1,2,2,2,0,0,2,2 (2ct 0st),1.000,
R Graham (SA),1899-1899,2,4,2,2,0,0,2,2 (2ct 0st),0.500,
A Greenwood (ENG),1877-1877,2,4,2,2,0,0,2,1 (1ct 0st),0.500,
GM Guard (IND),1958-1960,2,4,2,2,0,0,2,2 (2ct 0st),0.500,
S Guha (IND),1967-1969,4,8,2,2,0,0,2,1 (1ct 0st),0.250,
DA Gunawardene (SL),1999-2005,6,9,2,2,0,0,2,1 (1ct 0st),0.222,
Gursharan Singh (IND),1990-1990,1,2,2,2,0,0,2,1 (1ct 0st),1.000,
JW Guy (NZ),1955-1961,12,15,2,2,0,0,2,1 (1ct 0st),0.133,
JR Hammond (AUS),1973-1973,5,10,2,2,0,0,2,2 (2ct 0st),0.200,
Lord Harris (ENG),1879-1884,4,7,2,2,0,0,2,1 (1ct 0st),0.285,
JC Hartley (ENG),1906-1906,2,3,2,2,0,0,2,1 (1ct 0st),0.666,
Hashmatullah Shahidi (AFG),2018-2023,6,11,2,2,0,0,2,1 (1ct 0st),0.181,
MJ Haslam (NZ),1992-1995,4,6,2,2,0,0,2,2 (2ct 0st),0.333,
EG Hayes (ENG),1906-1912,5,10,2,2,0,0,2,1 (1ct 0st),0.200,
RGA Headley (WI),1973-1973,2,4,2,2,0,0,2,1 (1ct 0st),0.500,
CW Henderson (SA),2001-2002,7,14,2,2,0,0,2,1 (1ct 0st),0.142,
O Henry (SA),1992-1993,3,5,2,2,0,0,2,2 (2ct 0st),0.400,
JC Hill (AUS),1953-1955,3,5,2,2,0,0,2,1 (1ct 0st),0.400,
DE Hoare (AUS),1961-1961,1,2,2,2,0,0,2,1 (1ct 0st),1.000,
TG Hogan (AUS),1983-1984,7,11,2,2,0,0,2,1 (1ct 0st),0.181,
WE Hollies (ENG),1935-1950,13,23,2,2,0,0,2,1 (1ct 0st),0.086,
BC Hollioake (ENG),1997-1998,2,4,2,2,0,0,2,1 (1ct 0st),0.500,
L Hone (ENG),1879-1879,1,2,2,2,0,2,0,2 (2ct 0st),1.000,
MJ Horton (ENG),1959-1959,2,4,2,2,0,0,2,1 (1ct 0st),0.500,
R Howorth (ENG),1947-1948,5,10,2,2,0,0,2,1 (1ct 0st),0.200,
MJ Humphreys (IRE),2023-2023,1,1,2,2,0,0,2,2 (2ct 0st),2.000,
A Hurwood (AUS),1930-1931,2,4,2,2,0,0,2,2 (2ct 0st),0.500,
Iftikhar Ahmed (PAK),2016-2022,4,5,2,2,0,0,2,1 (1ct 0st),0.400,
RC Irani (ENG),1996-1999,3,5,2,2,0,0,2,2 (2ct 0st),0.400,
Irfan Fazil (PAK),2000-2000,1,2,2,2,0,0,2,1 (1ct 0st),1.000,
BL Irvine (SA),1970-1970,4,8,2,2,0,0,2,1 (1ct 0st),0.250,
JB Iverson (AUS),1950-1951,5,10,2,2,0,0,2,1 (1ct 0st),0.200,
RJD Jamshedji (IND),1933-1933,1,2,2,2,0,0,2,2 (2ct 0st),1.000,
MP Jarvis (ZIM),1992-1994,5,8,2,2,0,0,2,1 (1ct 0st),0.250,
PW Jarvis (ENG),1988-1993,9,16,2,2,0,0,2,1 (1ct 0st),0.125,
MDUS Jayasundera (SL),2015-2015,2,4,2,2,0,0,2,1 (1ct 0st),0.500,
P Jayawickrama (SL),2021-2022,5,10,2,2,0,0,2,1 (1ct 0st),0.200,
VB John (SL),1983-1984,6,9,2,2,0,0,2,1 (1ct 0st),0.222,
LJ Johnson (AUS),1948-1948,1,2,2,2,0,0,2,2 (2ct 0st),1.000,
Jubair Hossain (BAN),2014-2015,6,9,2,2,0,0,2,1 (1ct 0st),0.222,
H Jupp (ENG),1877-1877,2,4,2,2,0,0,2,2 (2ct 0st),0.500,
BR Jurangpathy (SL),1985-1986,2,3,2,2,0,0,2,2 (2ct 0st),0.666,
S Kalavitigoda (SL),2005-2005,1,1,2,2,0,0,2,2 (2ct 0st),2.000,
LWS Kaluperuma (SL),1982-1982,2,4,2,2,0,0,2,2 (2ct 0st),0.500,
M Kartik (IND),2000-2004,8,15,2,2,0,0,2,1 (1ct 0st),0.133,
TK Kendall (AUS),1877-1877,2,4,2,2,0,0,2,1 (1ct 0st),0.500,
RJ Kennedy (NZ),1996-1996,4,8,2,2,0,0,2,1 (1ct 0st),0.250,
Khaled Mahmud (BAN),2001-2003,12,17,2,2,0,0,2,1 (1ct 0st),0.117,
ET Killick (ENG),1929-1929,2,4,2,2,0,0,2,1 (1ct 0st),0.500,
LA King (WI),1962-1968,2,4,2,2,0,0,2,1 (1ct 0st),0.500,
RD King (WI),1999-2005,19,34,2,2,0,0,2,1 (1ct 0st),0.058,
RK Kleinveldt (SA),2012-2013,4,7,2,2,0,0,2,1 (1ct 0st),0.285,
MP Kuhnemann (AUS),2023-2023,3,5,2,2,0,0,2,1 (1ct 0st),0.400,
P Kumar (IND),2011-2011,6,11,2,2,0,0,2,2 (2ct 0st),0.181,
VV Kumar (IND),1961-1961,2,4,2,2,0,0,2,1 (1ct 0st),0.500,
GA Lamb (ZIM),2011-2011,1,2,2,2,0,0,2,1 (1ct 0st),1.000,
CK Langeveldt (SA),2005-2006,6,11,2,2,0,0,2,1 (1ct 0st),0.181,
GB Lawrence (SA),1961-1962,5,10,2,2,0,0,2,2 (2ct 0st),0.200,
WS Lees (ENG),1906-1906,5,9,2,2,0,0,2,1 (1ct 0st),0.222,
IB Leggat (NZ),1954-1954,1,2,2,2,0,0,2,2 (2ct 0st),1.000,
PJ Loader (ENG),1954-1959,13,26,2,2,0,0,2,1 (1ct 0st),0.076,
Hon.A Lyttelton (ENG),1880-1884,4,7,2,2,0,2,0,1 (1ct 0st),0.285,
AB McDonald (AUS),2009-2009,4,7,2,2,0,0,2,1 (1ct 0st),0.285,
NC McGarrell (WI),2001-2001,4,8,2,2,0,0,2,1 (1ct 0st),0.250,
PG McShane (AUS),1885-1888,3,5,2,2,0,0,2,1 (1ct 0st),0.400,
NJ Maddinson (AUS),2016-2016,3,6,2,2,0,0,2,1 (1ct 0st),0.333,
IS Madray (WI),1958-1958,2,4,2,2,0,0,2,1 (1ct 0st),0.500,
JN Maguire (AUS),1983-1984,3,5,2,2,0,0,2,2 (2ct 0st),0.400,
AO Malhotra (IND),1982-1985,7,11,2,2,0,0,2,1 (1ct 0st),0.181,
AL Mann (AUS),1977-1978,4,7,2,2,0,0,2,1 (1ct 0st),0.285,
DA Marillier (ZIM),2000-2002,5,9,2,2,0,0,2,1 (1ct 0st),0.222,
Marshall Ayub (BAN),2013-2014,3,4,2,2,0,0,2,1 (1ct 0st),0.500,
F Martin (ENG),1890-1892,2,4,2,2,0,0,2,1 (1ct 0st),0.500,
FR Martin (WI),1928-1931,9,12,2,2,0,0,2,1 (1ct 0st),0.166,
SW Masakadza (ZIM),2012-2014,5,9,2,2,0,0,2,1 (1ct 0st),0.222,
AM Matheson (NZ),1930-1931,2,3,2,2,0,0,2,2 (2ct 0st),0.666,
ER Mayne (AUS),1912-1921,4,7,2,2,0,0,2,2 (2ct 0st),0.285,
M Mbangwa (ZIM),1996-2000,15,25,2,2,0,0,2,1 (1ct 0st),0.080,
JA McCollum (IRE),2019-2023,6,10,2,2,0,0,2,1 (1ct 0st),0.200,
Mehrab Hossain jnr (BAN),2007-2009,7,11,2,2,0,0,2,1 (1ct 0st),0.181,
BAW Mendis (SL),2008-2014,19,31,2,2,0,0,2,1 (1ct 0st),0.064,
WE Merritt (NZ),1930-1931,6,10,2,2,0,0,2,2 (2ct 0st),0.200,
AG Milkha Singh (IND),1960-1961,4,7,2,2,0,0,2,1 (1ct 0st),0.285,
WH Milton (SA),1889-1892,3,4,2,2,0,0,2,1 (1ct 0st),0.500,
F Mitchell (ENG/SA),1899-1912,5,8,2,2,0,0,2,1 (1ct 0st),0.250,
Mohammad Nabi (AFG),2018-2019,3,5,2,2,0,0,2,2 (2ct 0st),0.400,
AM Moir (NZ),1951-1959,17,21,2,2,0,0,2,1 (1ct 0st),0.095,
Mosaddek Hossain (BAN),2017-2022,4,7,2,2,0,0,2,1 (1ct 0st),0.285,
G Motie (WI),2022-2023,4,8,2,2,0,0,2,1 (1ct 0st),0.250,
SA Muller (AUS),1999-1999,2,4,2,2,0,0,2,1 (1ct 0st),0.500,
CT Mumba (ZIM),2016-2020,3,6,2,2,0,0,2,1 (1ct 0st),0.333,
T Murphy (AUS),2023-2023,6,10,2,2,0,0,2,1 (1ct 0st),0.200,
N M'shangwe (ZIM),2014-2014,2,4,2,2,0,0,2,1 (1ct 0st),0.500,
Naeem Islam (BAN),2008-2012,8,15,2,2,0,0,2,1 (1ct 0st),0.133,
Nafees Iqbal (BAN),2004-2006,11,15,2,2,0,0,2,1 (1ct 0st),0.133,
MV Nagamootoo (WI),2000-2002,5,8,2,2,0,0,2,2 (2ct 0st),0.250,
R Nanan (WI),1980-1980,1,2,2,2,0,0,2,2 (2ct 0st),1.000,
SP Narine (WI),2012-2013,6,11,2,2,0,0,2,1 (1ct 0st),0.181,
A Ndlovu (ZIM),2020-2020,2,3,2,2,0,0,2,1 (1ct 0st),0.666,
RJ Nicol (NZ),2012-2012,2,4,2,2,0,0,2,1 (1ct 0st),0.500,
M Nissar (IND),1932-1936,6,11,2,2,0,0,2,1 (1ct 0st),0.181,
JM Noreiga (WI),1971-1971,4,7,2,2,0,0,2,2 (2ct 0st),0.285,
RK Nunes (WI),1928-1930,4,5,2,2,0,1,1,1 (1ct 0st),0.400,
J Nyumbu (ZIM),2014-2016,3,6,2,2,0,0,2,1 (1ct 0st),0.333,
NJ O'Brien (IRE),2018-2018,1,2,2,2,0,2,0,2 (2ct 0st),1.000,
J O'Connor (ENG),1929-1930,4,8,2,2,0,0,2,2 (2ct 0st),0.250,
DR O'Sullivan (NZ),1973-1976,11,19,2,2,0,0,2,1 (1ct 0st),0.105,
LCH Palairet (ENG),1902-1902,2,4,2,2,0,0,2,1 (1ct 0st),0.500,
Pankaj Singh (IND),2014-2014,2,3,2,2,0,0,2,1 (1ct 0st),0.666,
NM Parker (NZ),1976-1976,3,6,2,2,0,0,2,1 (1ct 0st),0.333,
LS Pascoe (AUS),1977-1982,14,27,2,2,0,0,2,1 (1ct 0st),0.074,
JM Patel (IND),1955-1960,7,11,2,2,0,0,2,1 (1ct 0st),0.181,
MM Patel (ENG),1996-1996,2,4,2,2,0,0,2,2 (2ct 0st),0.500,
Yuvraj of Patiala (IND),1934-1934,1,2,2,2,0,0,2,1 (1ct 0st),1.000,
KMA Paul (WI),2018-2019,3,5,2,2,0,0,2,1 (1ct 0st),0.400,
E Peate (ENG),1881-1886,9,15,2,2,0,0,2,1 (1ct 0st),0.133,
PDRL Perera (SL),1999-2002,8,14,2,2,0,0,2,1 (1ct 0st),0.142,
AL Phehlukwayo (SA),2017-2018,4,8,2,2,0,0,2,1 (1ct 0st),0.250,
WTS Porterfield (IRE),2018-2019,3,6,2,2,0,0,2,2 (2ct 0st),0.333,
JE Pothecary (SA),1960-1960,3,6,2,2,0,0,2,1 (1ct 0st),0.333,
AD Pougher (ENG),1892-1892,1,2,2,2,0,0,2,1 (1ct 0st),1.000,
AW Powell (SA),1899-1899,1,2,2,2,0,0,2,2 (2ct 0st),1.000,
D Pretorius (SA),2019-2020,3,6,2,2,0,0,2,1 (1ct 0st),0.333,
WFF Price (ENG),1938-1938,1,2,2,2,0,2,0,2 (2ct 0st),1.000,
HLE Promnitz (SA),1927-1928,2,4,2,2,0,0,2,1 (1ct 0st),0.500,
G Pullar (ENG),1959-1963,28,50,2,2,0,0,2,1 (1ct 0st),0.040,
PM Pushpakumara (SL),2017-2018,4,6,2,2,0,0,2,2 (2ct 0st),0.333,
AJ Pycroft (ZIM),1992-1992,3,5,2,2,0,0,2,1 (1ct 0st),0.400,
CG Rackemann (AUS),1982-1991,12,20,2,2,0,0,2,1 (1ct 0st),0.100,
RR Ramdass (WI),2005-2005,1,2,2,2,0,0,2,2 (2ct 0st),1.000,
S Ranatunga (SL),1994-1997,9,13,2,2,0,0,2,1 (1ct 0st),0.153,
Rashid Khan (PAK),1982-1985,4,7,2,2,0,0,2,1 (1ct 0st),0.285,
R Ravindra (NZ),2021-2022,3,6,2,2,0,0,2,2 (2ct 0st),0.333,
DA Renneberg (AUS),1966-1968,8,15,2,2,0,0,2,1 (1ct 0st),0.133,
JB Robertson (SA),1935-1936,3,5,2,2,0,0,2,1 (1ct 0st),0.400,
A Rose-Innes (SA),1889-1889,2,3,2,2,0,0,2,2 (2ct 0st),0.666,
TW Routledge (SA),1892-1896,4,5,2,2,0,0,2,1 (1ct 0st),0.400,
VPFA Royle (ENG),1879-1879,1,2,2,2,0,0,2,2 (2ct 0st),1.000,
Saleem Jaffar (PAK),1986-1992,14,26,2,2,0,0,2,1 (1ct 0st),0.076,
RO Scarlett (WI),1960-1960,3,6,2,2,0,0,2,1 (1ct 0st),0.333,
BN Schultz (SA),1992-1997,9,15,2,2,0,0,2,1 (1ct 0st),0.133,
CP Senanayake (SL),1991-1991,3,6,2,2,0,0,2,1 (1ct 0st),0.333,
MA Seymour (SA),1963-1970,7,12,2,2,0,0,2,1 (1ct 0st),0.166,
Shafiul Islam (BAN),2010-2017,11,21,2,2,0,0,2,1 (1ct 0st),0.095,
OA Shah (ENG),2006-2009,6,9,2,2,0,0,2,1 (1ct 0st),0.222,
Shaheen Shah Afridi (PAK),2018-2023,27,47,2,2,0,0,2,1 (1ct 0st),0.042,
Shahid Israr (PAK),1976-1976,1,2,2,2,0,2,0,2 (2ct 0st),1.000,
A Shahzad (ENG),2010-2010,1,2,2,2,0,0,2,1 (1ct 0st),1.000,
G Sharma (IND),1985-1990,5,9,2,2,0,0,2,1 (1ct 0st),0.222,
DA Sharpe (PAK),1959-1959,3,6,2,2,0,0,2,2 (2ct 0st),0.333,
JW Sharpe (ENG),1890-1892,3,6,2,2,0,0,2,1 (1ct 0st),0.333,
PP Shaw (IND),2018-2020,5,10,2,2,0,0,2,2 (2ct 0st),0.200,
BK Shepherd (AUS),1963-1965,9,18,2,2,0,0,2,1 (1ct 0st),0.111,
GH Shepstone (SA),1896-1899,2,3,2,2,0,0,2,2 (2ct 0st),0.666,
GC Shillingford (WI),1969-1972,7,12,2,2,0,0,2,2 (2ct 0st),0.166,
MJF Shrimpton (NZ),1963-1974,10,17,2,2,0,0,2,1 (1ct 0st),0.117,
ARS Silva (SL),2017-2019,12,23,2,2,0,0,2,1 (1ct 0st),0.086,
CEW Silverwood (ENG),1996-2002,6,9,2,2,0,0,2,1 (1ct 0st),0.222,
DJ Sincock (AUS),1964-1966,3,5,2,2,0,0,2,2 (2ct 0st),0.400,
CK Singh (WI),1960-1960,2,4,2,2,0,0,2,1 (1ct 0st),0.500,
VA Singh (WI),2017-2017,3,6,2,2,0,0,2,1 (1ct 0st),0.333,
L Sipamla (SA),2020-2022,3,6,2,2,0,0,2,1 (1ct 0st),0.333,
CJE Smith (SA),1902-1902,3,6,2,2,0,0,2,2 (2ct 0st),0.333,
DR Smith (ENG),1961-1962,5,8,2,2,0,0,2,1 (1ct 0st),0.250,
FW Smith (SA),1889-1896,3,4,2,2,0,2,0,2 (2ct 0st),0.500,
SD Snooke (SA),1907-1907,1,2,2,2,0,0,2,2 (2ct 0st),1.000,
Sohail Khan (PAK),2009-2016,9,17,2,2,0,0,2,1 (1ct 0st),0.117,
Sohail Tanvir (PAK),2007-2007,2,4,2,2,0,0,2,1 (1ct 0st),0.500,
SW Sohoni (IND),1946-1951,4,6,2,2,0,0,2,1 (1ct 0st),0.333,
J Southerton (ENG),1877-1877,2,4,2,2,0,0,2,1 (1ct 0st),0.500,
GR Stead (NZ),1999-1999,5,9,2,2,0,0,2,1 (1ct 0st),0.222,
GB Stevens (AUS),1959-1960,4,8,2,2,0,0,2,1 (1ct 0st),0.250,
RB Stewart (SA),1889-1889,1,2,2,2,0,0,2,2 (2ct 0st),1.000,
CEL Stuart (WI),2000-2001,6,12,2,2,0,0,2,1 (1ct 0st),0.166,
MJ Swepson (AUS),2022-2022,4,7,2,2,0,0,2,1 (1ct 0st),0.285,
Khaled Ahmed (BAN),2018-2023,12,22,2,2,0,0,2,1 (1ct 0st),0.090,
AB Tancred (SA),1889-1889,2,3,2,2,0,0,2,1 (1ct 0st),0.666,
Taskin Ahmed (BAN),2017-2023,13,24,2,2,0,0,2,1 (1ct 0st),0.083,
FW Tate (ENG),1902-1902,1,2,2,2,0,0,2,1 (1ct 0st),1.000,
DD Taylor (NZ),1947-1956,3,5,2,2,0,0,2,1 (1ct 0st),0.400,
VP Terry (ENG),1984-1984,2,3,2,2,0,0,2,1 (1ct 0st),0.666,
LF Townsend (ENG),1930-1934,4,8,2,2,0,0,2,1 (1ct 0st),0.250,
JC Tredwell (ENG),2010-2015,2,4,2,2,0,0,2,1 (1ct 0st),0.500,
J Trim (WI),1948-1952,4,8,2,2,0,0,2,1 (1ct 0st),0.250,
GB Troup (NZ),1976-1986,15,28,2,2,0,0,2,1 (1ct 0st),0.071,
LR Tuckett (SA),1914-1914,1,2,2,2,0,0,2,2 (2ct 0st),1.000,
GE Tyldesley (ENG),1921-1929,14,25,2,2,0,0,2,1 (1ct 0st),0.080,
ML Udawatte (SL),2018-2018,2,4,2,2,0,0,2,1 (1ct 0st),0.500,
P Utseya (ZIM),2004-2013,4,6,2,2,0,0,2,2 (2ct 0st),0.333,
BH Valentine (ENG),1933-1939,7,13,2,2,0,0,2,1 (1ct 0st),0.153,
BV Vitori (ZIM),2011-2013,4,7,2,2,0,0,2,1 (1ct 0st),0.285,
E Wainwright (ENG),1893-1898,5,8,2,2,0,0,2,1 (1ct 0st),0.250,
FH Walters (AUS),1885-1885,1,1,2,2,0,0,2,2 (2ct 0st),2.000,
B Warnapura (SL),1982-1982,4,7,2,2,0,0,2,1 (1ct 0st),0.285,
WJ Watson (AUS),1955-1955,4,7,2,2,0,0,2,1 (1ct 0st),0.285,
PN Webb (NZ),1980-1980,2,4,2,2,0,0,2,1 (1ct 0st),0.500,
AJ Webbe (ENG),1879-1879,1,2,2,2,0,0,2,2 (2ct 0st),1.000,
DN Wellalage (SL),2022-2022,1,2,2,2,0,0,2,2 (2ct 0st),1.000,
AW Wellard (ENG),1937-1938,2,4,2,2,0,0,2,2 (2ct 0st),0.500,
MD Wettimuny (SL),1983-1983,2,3,2,2,0,0,2,2 (2ct 0st),0.666,
MR Whitney (AUS),1981-1992,12,24,2,2,0,0,2,1 (1ct 0st),0.083,
EAV Williams (WI),1939-1948,4,8,2,2,0,0,2,1 (1ct 0st),0.250,
Zakir Hasan (BAN),2022-2023,3,6,2,2,0,0,2,2 (2ct 0st),0.333,
K Zondo (SA),2022-2023,5,8,2,2,0,0,2,1 (1ct 0st),0.250,
Zulqarnain Haider (PAK),2010-2010,1,2,2,2,0,2,0,2 (2ct 0st),1.000,
VR Aaron (IND),2011-2015,9,15,1,1,0,0,1,1 (1ct 0st),0.066,
Abdul Kadir (PAK),1964-1965,4,8,1,0,1,0,0,1 (0ct 1st),0.125,
Abu Jayed (BAN),2018-2021,13,19,1,1,0,0,1,1 (1ct 0st),0.052,
HD Ackerman (SA),1998-1998,4,8,1,1,0,0,1,1 (1ct 0st),0.125,
AR Adams (NZ),2002-2002,1,2,1,1,0,0,1,1 (1ct 0st),0.500,
FS Ahangama (SL),1985-1985,3,6,1,1,0,0,1,1 (1ct 0st),0.166,
Aizaz Cheema (PAK),2011-2012,7,14,1,1,0,0,1,1 (1ct 0st),0.071,
Ali Naqvi (PAK),1997-1998,5,8,1,1,0,0,1,1 (1ct 0st),0.125,
IBA Allen (WI),1991-1991,2,3,1,1,0,0,1,1 (1ct 0st),0.333,
KN Amalean (SL),1986-1988,2,2,1,1,0,0,1,1 (1ct 0st),0.500,
JH Anderson (SA),1902-1902,1,2,1,1,0,0,1,1 (1ct 0st),0.500,
RW Anderson (NZ),1976-1978,9,16,1,1,0,0,1,1 (1ct 0st),0.062,
WM Anderson (NZ),1946-1946,1,1,1,1,0,0,1,1 (1ct 0st),1.000,
KV Andrew (ENG),1954-1963,2,3,1,1,0,1,0,1 (1ct 0st),0.333,
B Andrews (NZ),1973-1974,2,3,1,1,0,0,1,1 (1ct 0st),0.333,
J Angel (AUS),1993-1995,4,7,1,1,0,0,1,1 (1ct 0st),0.142,
ZS Ansari (ENG),2016-2016,3,6,1,1,0,0,1,1 (1ct 0st),0.166,
KIC Asalanka (SL),2021-2022,3,5,1,1,0,0,1,1 (1ct 0st),0.200,
Azeem Hafeez (PAK),1983-1985,18,28,1,1,0,0,1,1 (1ct 0st),0.035,
FT Badcock (NZ),1930-1933,7,10,1,1,0,0,1,1 (1ct 0st),0.100,
SV Bahutule (IND),2001-2001,2,3,1,1,0,0,1,1 (1ct 0st),0.333,
LS Baker (WI),2008-2009,4,7,1,1,0,0,1,1 (1ct 0st),0.142,
L Balaji (IND),2003-2005,8,15,1,1,0,0,1,1 (1ct 0st),0.066,
JC Balderstone (ENG),1976-1976,2,4,1,1,0,0,1,1 (1ct 0st),0.250,
JT Ball (ENG),2016-2017,4,6,1,1,0,0,1,1 (1ct 0st),0.166,
RT Barber (NZ),1956-1956,1,2,1,1,0,0,1,1 (1ct 0st),0.500,
W Barber (ENG),1935-1935,2,4,1,1,0,0,1,1 (1ct 0st),0.250,
KJ Barnett (ENG),1988-1989,4,8,1,1,0,0,1,1 (1ct 0st),0.125,
JE Barrett (AUS),1890-1890,2,4,1,1,0,0,1,1 (1ct 0st),0.250,
HV Baumgartner (SA),1913-1913,1,1,1,1,0,0,1,1 (1ct 0st),1.000,
MA Beer (AUS),2011-2012,2,3,1,1,0,0,1,1 (1ct 0st),0.333,
W Bell (NZ),1954-1954,2,4,1,1,0,0,1,1 (1ct 0st),0.250,
P Bhandari (IND),1955-1956,3,6,1,1,0,0,1,1 (1ct 0st),0.166,
BA Bolton (NZ),1959-1959,2,2,1,1,0,0,1,1 (1ct 0st),0.500,
JT Botten (SA),1965-1965,3,6,1,1,0,0,1,1 (1ct 0st),0.166,
MP Bowden (ENG),1889-1889,2,4,1,1,0,1,0,1 (1ct 0st),0.250,
BP Bracewell (NZ),1978-1985,6,11,1,1,0,0,1,1 (1ct 0st),0.090,
DH Brain (ZIM),1992-1995,9,16,1,1,0,0,1,1 (1ct 0st),0.062,
GR Breese (WI),2002-2002,1,2,1,1,0,0,1,1 (1ct 0st),0.500,
DV Brennan (ENG),1951-1951,2,4,1,0,1,0,0,1 (0ct 1st),0.250,
GB Brent (ZIM),1999-2001,4,6,1,1,0,0,1,1 (1ct 0st),0.166,
AW Briscoe (SA),1935-1939,2,3,1,1,0,0,1,1 (1ct 0st),0.333,
HR Bromley-Davenport (ENG),1896-1899,4,8,1,1,0,0,1,1 (1ct 0st),0.125,
D Brookes (ENG),1948-1948,1,2,1,1,0,0,1,1 (1ct 0st),0.500,
A Brown (ENG),1961-1961,2,4,1,1,0,0,1,1 (1ct 0st),0.250,
SJE Brown (ENG),1996-1996,1,2,1,1,0,0,1,1 (1ct 0st),0.500,
CR Browne (WI),1928-1930,4,6,1,1,0,0,1,1 (1ct 0st),0.166,
CGD Burger (SA),1958-1958,2,4,1,1,0,0,1,1 (1ct 0st),0.250,
RP Burl (ZIM),2017-2021,3,5,1,1,0,0,1,1 (1ct 0st),0.200,
MG Burmester (ZIM),1992-1992,3,5,1,1,0,0,1,1 (1ct 0st),0.200,
IP Butchart (ZIM),1995-1995,1,2,1,1,0,0,1,1 (1ct 0st),0.500,
HJ Butler (ENG),1947-1948,2,4,1,1,0,0,1,1 (1ct 0st),0.250,
IW Callen (AUS),1978-1978,1,2,1,1,0,0,1,1 (1ct 0st),0.500,
GD Campbell (AUS),1989-1990,4,8,1,1,0,0,1,1 (1ct 0st),0.125,
GM Carew (WI),1935-1949,4,8,1,1,0,0,1,1 (1ct 0st),0.125,
HW Chapman (SA),1914-1921,2,4,1,1,0,0,1,1 (1ct 0st),0.250,
PP Chawla (IND),2006-2012,3,6,1,1,0,0,1,1 (1ct 0st),0.166,
GA Chevalier (SA),1970-1970,1,2,1,1,0,0,1,1 (1ct 0st),0.500,
JH Childs (ENG),1988-1988,2,3,1,1,0,0,1,1 (1ct 0st),0.333,
TS Chisoro (ZIM),2017-2021,3,3,1,1,0,0,1,1 (1ct 0st),0.333,
R Clarke (ENG),2003-2003,2,4,1,1,0,0,1,1 (1ct 0st),0.250,
JC Clay (ENG),1935-1935,1,2,1,1,0,0,1,1 (1ct 0st),0.500,
SK Coen (SA),1927-1928,2,4,1,1,0,0,1,1 (1ct 0st),0.250,
LJ Coldwell (ENG),1962-1964,7,14,1,1,0,0,1,1 (1ct 0st),0.071,
DJ Colley (AUS),1972-1972,3,6,1,1,0,0,1,1 (1ct 0st),0.166,
JMM Commaille (SA),1910-1928,12,19,1,1,0,0,1,1 (1ct 0st),0.052,
DP Conyngham (SA),1923-1923,1,2,1,1,0,0,1,1 (1ct 0st),0.500,
AHC Cooper (SA),1913-1913,1,1,1,1,0,0,1,1 (1ct 0st),1.000,
WH Cooper (AUS),1881-1884,2,4,1,1,0,0,1,1 (1ct 0st),0.250,
GA Cope (ENG),1977-1978,3,5,1,1,0,0,1,1 (1ct 0st),0.200,
WH Copson (ENG),1939-1947,3,6,1,1,0,0,1,1 (1ct 0st),0.166,
JT Cottam (AUS),1887-1887,1,2,1,1,0,0,1,1 (1ct 0st),0.500,
JL Cox (SA),1913-1914,3,4,1,1,0,0,1,1 (1ct 0st),0.250,
J Cranston (ENG),1890-1890,1,2,1,1,0,0,1,1 (1ct 0st),0.500,
WPA Crawford (AUS),1956-1956,4,8,1,1,0,0,1,1 (1ct 0st),0.125,
IB Cromb (NZ),1931-1932,5,7,1,1,0,0,1,1 (1ct 0st),0.142,
AC Cummins (WI),1993-1994,5,9,1,1,0,0,1,1 (1ct 0st),0.111,
RS Cunis (NZ),1964-1972,20,38,1,1,0,0,1,1 (1ct 0st),0.026,
KM Dabengwa (ZIM),2005-2005,3,4,1,1,0,0,1,1 (1ct 0st),0.250,
A Dananjaya (SL),2018-2019,6,12,1,1,0,0,1,1 (1ct 0st),0.083,
HT Dani (IND),1952-1952,1,2,1,1,0,0,1,1 (1ct 0st),0.500,
BA Davis (WI),1965-1965,4,7,1,1,0,0,1,1 (1ct 0st),0.142,
FI de Caires (WI),1930-1930,3,6,1,1,0,0,1,1 (1ct 0st),0.166,
M de Lange (SA),2011-2012,2,4,1,1,0,0,1,1 (1ct 0st),0.250,
EW Dempster (NZ),1953-1954,5,9,1,1,0,0,1,1 (1ct 0st),0.111,
SI de Saram (SL),1999-2000,4,8,1,1,0,0,1,1 (1ct 0st),0.125,
SKL de Silva (SL),1997-1997,3,4,1,1,0,1,0,1 (1ct 0st),0.250,
WRS de Silva (SL),2002-2007,3,6,1,1,0,0,1,1 (1ct 0st),0.166,
F de Wet (SA),2009-2010,2,4,1,1,0,0,1,1 (1ct 0st),0.250,
R Dhanraj (WI),1994-1996,4,8,1,1,0,0,1,1 (1ct 0st),0.125,
CD Dixon (SA),1914-1914,1,2,1,1,0,0,1,1 (1ct 0st),0.500,
HE Dollery (ENG),1947-1950,4,8,1,1,0,0,1,1 (1ct 0st),0.125,
A Dolphin (ENG),1921-1921,1,2,1,1,0,1,0,1 (1ct 0st),0.500,
A Ducat (ENG),1921-1921,1,2,1,1,0,0,1,1 (1ct 0st),0.500,
T Duffin (ZIM),2005-2005,2,3,1,1,0,0,1,1 (1ct 0st),0.333,
OR Dunell (SA),1889-1889,2,3,1,1,0,0,1,1 (1ct 0st),0.333,
JF du Toit (SA),1892-1892,1,1,1,1,0,0,1,1 (1ct 0st),1.000,
G Dymock (AUS),1974-1980,21,35,1,1,0,0,1,1 (1ct 0st),0.028,
Ebadot Hossain (BAN),2019-2023,20,32,1,1,0,0,1,1 (1ct 0st),0.031,
JD Edwards (AUS),1888-1888,3,4,1,1,0,0,1,1 (1ct 0st),0.250,
Elias Sunny (BAN),2011-2013,4,7,1,1,0,0,1,1 (1ct 0st),0.142,
S Elworthy (SA),1998-2002,4,8,1,1,0,0,1,1 (1ct 0st),0.125,
Enamul Haque (BAN),2001-2003,10,13,1,1,0,0,1,1 (1ct 0st),0.076,
CN Evans (ZIM),1996-2003,3,4,1,1,0,0,1,1 (1ct 0st),0.250,
GM Ewing (ZIM),2003-2005,3,5,1,1,0,0,1,1 (1ct 0st),0.200,
Fahim Muntasir (BAN),2002-2002,3,4,1,1,0,0,1,1 (1ct 0st),0.250,
K Farnes (ENG),1934-1939,15,27,1,1,0,0,1,1 (1ct 0st),0.037,
KHRK Fernando (SL),2002-2002,2,3,1,1,0,0,1,1 (1ct 0st),0.333,
MD Fisher (ENG),2022-2022,1,2,1,1,0,0,1,1 (1ct 0st),0.500,
LB Fishlock (ENG),1936-1947,4,7,1,1,0,0,1,1 (1ct 0st),0.142,
BC Francis (AUS),1972-1972,3,6,1,1,0,0,1,1 (1ct 0st),0.166,
HH Francis (SA),1899-1899,2,4,1,1,0,0,1,1 (1ct 0st),0.250,
JER Gallian (ENG),1995-1995,3,4,1,1,0,0,1,1 (1ct 0st),0.250,
A Gandotra (IND),1969-1969,2,4,1,1,0,0,1,1 (1ct 0st),0.250,
BBM Gaskin (WI),1948-1948,2,4,1,1,0,0,1,1 (1ct 0st),0.250,
RA Gaunt (AUS),1958-1964,3,5,1,1,0,0,1,1 (1ct 0st),0.200,
GL Gibbs (WI),1955-1955,1,2,1,1,0,0,1,1 (1ct 0st),0.500,
WF Giffen (AUS),1887-1892,3,5,1,1,0,0,1,1 (1ct 0st),0.200,
MR Gillespie (NZ),2007-2012,5,8,1,1,0,0,1,1 (1ct 0st),0.125,
H Gimblett (ENG),1936-1939,3,6,1,1,0,0,1,1 (1ct 0st),0.166,
N Gordon (SA),1938-1939,5,8,1,1,0,0,1,1 (1ct 0st),0.125,
AR Gover (ENG),1936-1946,4,7,1,1,0,0,1,1 (1ct 0st),0.142,
EM Grace (ENG),1880-1880,1,2,1,1,0,0,1,1 (1ct 0st),0.500,
T Greenhough (ENG),1959-1960,4,8,1,1,0,0,1,1 (1ct 0st),0.125,
EJ Gregory (AUS),1877-1877,1,2,1,1,0,0,1,1 (1ct 0st),0.500,
RG Gregory (AUS),1937-1937,2,4,1,1,0,0,1,1 (1ct 0st),0.250,
MG Grell (WI),1930-1930,1,2,1,1,0,0,1,1 (1ct 0st),0.500,
CG Halse (SA),1964-1964,3,6,1,1,0,0,1,1 (1ct 0st),0.166,
RA Hamence (AUS),1947-1948,3,6,1,1,0,0,1,1 (1ct 0st),0.166,
F Hand (IRE),2023-2023,1,2,1,1,0,0,1,1 (1ct 0st),0.500,
J Hardstaff snr (ENG),1907-1908,5,10,1,1,0,0,1,1 (1ct 0st),0.100,
TA Harris (SA),1947-1949,3,6,1,1,0,0,1,1 (1ct 0st),0.166,
J Harry (AUS),1895-1895,1,2,1,1,0,0,1,1 (1ct 0st),0.500,
MJ Hartigan (AUS),1908-1908,2,4,1,1,0,0,1,1 (1ct 0st),0.250,
Haseeb Ahsan (PAK),1958-1962,12,20,1,1,0,0,1,1 (1ct 0st),0.050,
Hasibul Hossain (BAN),2000-2001,5,6,1,1,0,0,1,1 (1ct 0st),0.166,
JW Hastings (AUS),2012-2012,1,2,1,1,0,0,1,1 (1ct 0st),0.500,
A Hearne (ENG),1892-1892,1,2,1,1,0,0,1,1 (1ct 0st),0.500,
M Henderson (NZ),1930-1930,1,2,1,1,0,0,1,1 (1ct 0st),0.500,
MC Henriques (AUS),2013-2016,4,7,1,1,0,0,1,1 (1ct 0st),0.142,
PA Hibbert (AUS),1977-1977,1,2,1,1,0,0,1,1 (1ct 0st),0.500,
A Hill (ENG),1877-1877,2,4,1,1,0,0,1,1 (1ct 0st),0.250,
AJL Hill (ENG),1896-1896,3,6,1,1,0,0,1,1 (1ct 0st),0.166,
MJ Hilton (ENG),1950-1952,4,6,1,1,0,0,1,1 (1ct 0st),0.166,
ELG Hoad (WI),1928-1933,4,5,1,1,0,0,1,1 (1ct 0st),0.200,
GB Hogg (AUS),1996-2008,7,14,1,1,0,0,1,1 (1ct 0st),0.071,
JM Holland (AUS),2016-2018,4,8,1,1,0,0,1,1 (1ct 0st),0.125,
KW Hough (NZ),1959-1959,2,2,1,1,0,0,1,1 (1ct 0st),0.500,
WA Hunt (AUS),1932-1932,1,2,1,1,0,0,1,1 (1ct 0st),0.500,
LG Hylton (WI),1935-1939,6,12,1,1,0,0,1,1 (1ct 0st),0.083,
AP Igglesden (ENG),1989-1994,3,5,1,1,0,0,1,1 (1ct 0st),0.200,
DEJ Ironside (SA),1953-1954,3,5,1,1,0,0,1,1 (1ct 0st),0.200,
Israr Ali (PAK),1952-1959,4,7,1,1,0,0,1,1 (1ct 0st),0.142,
SD Jack (SA),1994-1995,2,4,1,1,0,0,1,1 (1ct 0st),0.250,
HL Jackson (ENG),1949-1961,2,4,1,1,0,0,1,1 (1ct 0st),0.250,
YBK Jaiswal (IND),2023-2023,2,4,1,1,0,0,1,1 (1ct 0st),0.250,
Javed Ahmadi (AFG),2018-2021,3,5,1,1,0,0,1,1 (1ct 0st),0.200,
NGRP Jayasuriya (SL),2022-2023,9,16,1,1,0,0,1,1 (1ct 0st),0.062,
CL Johnson (SA),1896-1896,1,1,1,1,0,0,1,1 (1ct 0st),1.000,
TF Johnson (WI),1939-1939,1,2,1,1,0,0,1,1 (1ct 0st),0.500,
EC Joyce (IRE),2018-2018,1,2,1,1,0,0,1,1 (1ct 0st),0.500,
Kabir Khan (PAK),1994-1995,4,7,1,1,0,0,1,1 (1ct 0st),0.142,
I Kaia (ZIM),2023-2023,2,3,1,1,0,0,1,1 (1ct 0st),0.333,
R Kaia (ZIM),2021-2021,3,4,1,1,0,0,1,1 (1ct 0st),0.250,
S Randiv (SL),2010-2012,12,21,1,1,0,0,1,1 (1ct 0st),0.047,
AR Kapoor (IND),1994-1996,4,7,1,1,0,0,1,1 (1ct 0st),0.142,
SS Karim (IND),2000-2000,1,2,1,1,0,1,0,1 (1ct 0st),0.500,
C Karunaratne (SL),2019-2019,1,2,1,1,0,0,1,1 (1ct 0st),0.500,
TJD Kelly (AUS),1877-1879,2,4,1,1,0,0,1,1 (1ct 0st),0.250,
RB Kenny (IND),1958-1960,5,8,1,1,0,0,1,1 (1ct 0st),0.125,
ESM Kentish (WI),1948-1954,2,4,1,1,0,0,1,1 (1ct 0st),0.250,
RB Kerr (AUS),1985-1985,2,4,1,1,0,0,1,1 (1ct 0st),0.250,
I Khan (SA),2009-2009,1,2,1,1,0,0,1,1 (1ct 0st),0.500,
G Kishenchand (IND),1947-1952,5,5,1,1,0,0,1,1 (1ct 0st),0.200,
AE Knight (ENG),1904-1904,3,6,1,1,0,0,1,1 (1ct 0st),0.166,
DJ Knight (ENG),1921-1921,2,4,1,1,0,0,1,1 (1ct 0st),0.250,
CM Kuggeleijn (NZ),1988-1988,2,4,1,1,0,0,1,1 (1ct 0st),0.250,
HG Kuhn (SA),2017-2017,4,8,1,1,0,0,1,1 (1ct 0st),0.125,
AP Kuiper (SA),1992-1992,1,2,1,1,0,0,1,1 (1ct 0st),0.500,
NM Kulkarni (IND),1997-2001,3,3,1,1,0,0,1,1 (1ct 0st),0.333,
RR Kulkarni (IND),1986-1987,3,6,1,1,0,0,1,1 (1ct 0st),0.166,
DSBP Kuruppu (SL),1987-1991,4,6,1,1,0,1,0,1 (1ct 0st),0.166,
MKGCP Lakshitha (SL),2002-2002,2,4,1,1,0,0,1,1 (1ct 0st),0.250,
Lall Singh (IND),1932-1932,1,2,1,1,0,0,1,1 (1ct 0st),0.500,
SG Law (AUS),1995-1995,1,2,1,1,0,0,1,1 (1ct 0st),0.500,
PK Lee (AUS),1931-1933,2,4,1,1,0,0,1,1 (1ct 0st),0.250,
GB Legge (ENG),1927-1930,5,8,1,1,0,0,1,1 (1ct 0st),0.125,
CFH Leslie (ENG),1882-1883,4,8,1,1,0,0,1,1 (1ct 0st),0.125,
HDG Leveson Gower (ENG),1910-1910,3,6,1,1,0,0,1,1 (1ct 0st),0.166,
SH Lewis (WI),2018-2018,2,2,1,1,0,0,1,1 (1ct 0st),0.500,
Liaqat Ali (PAK),1975-1978,5,7,1,1,0,0,1,1 (1ct 0st),0.142,
GFJ Liebenberg (SA),1998-1998,5,10,1,1,0,0,1,1 (1ct 0st),0.100,
James Lillywhite jnr (ENG),1877-1877,2,4,1,1,0,0,1,1 (1ct 0st),0.250,
NV Lindsay (SA),1921-1921,1,2,1,1,0,0,1,1 (1ct 0st),0.500,
WVS Ling (SA),1921-1923,6,12,1,1,0,0,1,1 (1ct 0st),0.083,
AF Lissette (NZ),1956-1956,2,2,1,1,0,0,1,1 (1ct 0st),0.500,
KS Lokuarachchi (SL),2003-2004,4,7,1,1,0,0,1,1 (1ct 0st),0.142,
AP Lucas (ENG),1879-1884,5,9,1,1,0,0,1,1 (1ct 0st),0.111,
MJ McCague (ENG),1993-1994,3,5,1,1,0,0,1,1 (1ct 0st),0.200,
CP McGahey (ENG),1902-1902,2,4,1,1,0,0,1,1 (1ct 0st),0.250,
J McIlwraith (AUS),1886-1886,1,1,1,1,0,0,1,1 (1ct 0st),1.000,
CJ McKay (AUS),2009-2009,1,2,1,1,0,0,1,1 (1ct 0st),0.500,
AH McKinnon (SA),1960-1967,8,16,1,1,0,0,1,1 (1ct 0st),0.062,
W Madhevere (ZIM),2021-2021,2,4,1,1,0,0,1,1 (1ct 0st),0.250,
TN Madondo (ZIM),1998-2000,3,6,1,1,0,0,1,1 (1ct 0st),0.166,
D Madushanka (SL),2023-2023,1,1,1,1,0,0,1,1 (1ct 0st),1.000,
S Mahmood (ENG),2022-2022,2,4,1,1,0,0,1,1 (1ct 0st),0.250,
NB Mahwire (ZIM),2002-2005,10,15,1,1,0,0,1,1 (1ct 0st),0.066,
T Makoni (ZIM),2023-2023,2,3,1,1,0,0,1,1 (1ct 0st),0.333,
Mohammad Ali (PAK),2022-2022,2,4,1,1,0,0,1,1 (1ct 0st),0.250,
A Maregwede (ZIM),2004-2004,2,2,1,1,0,0,1,1 (1ct 0st),0.500,
CS Marriott (ENG),1933-1933,1,2,1,1,0,0,1,1 (1ct 0st),0.500,
HJH Marshall (NZ),2000-2006,13,23,1,1,0,0,1,1 (1ct 0st),0.043,
RE Marshall (WI),1951-1952,4,8,1,1,0,0,1,1 (1ct 0st),0.125,
T Maruma (ZIM),2013-2021,4,7,1,1,0,0,1,1 (1ct 0st),0.142,
RAL Massie (AUS),1972-1973,6,12,1,1,0,0,1,1 (1ct 0st),0.083,
PS Masvaure (ZIM),2016-2021,8,13,1,1,0,0,1,1 (1ct 0st),0.076,
ADG Matthews (ENG),1937-1937,1,2,1,1,0,0,1,1 (1ct 0st),0.500,
CD Matthews (AUS),1986-1988,3,6,1,1,0,0,1,1 (1ct 0st),0.166,
KSA McKenzie (WI),2023-2023,1,2,1,1,0,0,1,1 (1ct 0st),0.500,
W Mead (ENG),1899-1899,1,2,1,1,0,0,1,1 (1ct 0st),0.500,
KR Meherhomji (IND),1936-1936,1,1,1,1,0,1,0,1 (1ct 0st),1.000,
VL Mehra (IND),1955-1964,8,16,1,1,0,0,1,1 (1ct 0st),0.062,
CA Merry (WI),1933-1933,2,2,1,1,0,0,1,1 (1ct 0st),0.500,
KD Meuleman (AUS),1946-1946,1,2,1,1,0,0,1,1 (1ct 0st),0.500,
PL Mhambrey (IND),1996-1996,2,4,1,1,0,0,1,1 (1ct 0st),0.250,
J Middleton (SA),1896-1902,6,11,1,1,0,0,1,1 (1ct 0st),0.090,
LSM Miller (NZ),1953-1958,13,20,1,1,0,0,1,1 (1ct 0st),0.050,
FW Milligan (ENG),1899-1899,2,4,1,1,0,0,1,1 (1ct 0st),0.250,
CH Mills (SA),1892-1892,1,1,1,1,0,0,1,1 (1ct 0st),1.000,
JE Mills (NZ),1930-1933,7,10,1,1,0,0,1,1 (1ct 0st),0.100,
TB Mitchell (ENG),1933-1935,5,9,1,1,0,0,1,1 (1ct 0st),0.111,
Mohammad Ayub (PAK),2012-2012,1,2,1,1,0,0,1,1 (1ct 0st),0.500,
Mohammad Farooq (PAK),1960-1965,7,11,1,1,0,0,1,1 (1ct 0st),0.090,
Mohammad Hussain (PAK),1996-1998,2,3,1,1,0,0,1,1 (1ct 0st),0.333,
Mohammad Naim (BAN),2022-2022,1,1,1,1,0,0,1,1 (1ct 0st),1.000,
Mohammad Ramzan (PAK),1997-1997,1,1,1,1,0,0,1,1 (1ct 0st),1.000,
Mohammad Talha (PAK),2009-2014,4,6,1,1,0,0,1,1 (1ct 0st),0.166,
Mohammad Wasim (1) (PAK),2022-2022,2,4,1,1,0,0,1,1 (1ct 0st),0.250,
D Mohammed (WI),2004-2006,5,10,1,1,0,0,1,1 (1ct 0st),0.100,
AW Mold (ENG),1893-1893,3,5,1,1,0,0,1,1 (1ct 0st),0.200,
BD Morrison (NZ),1963-1963,1,1,1,1,0,0,1,1 (1ct 0st),1.000,
EA Moseley (WI),1990-1990,2,4,1,1,0,0,1,1 (1ct 0st),0.250,
H Moses (AUS),1887-1895,6,12,1,1,0,0,1,1 (1ct 0st),0.083,
AE Moss (ENG),1954-1960,9,17,1,1,0,0,1,1 (1ct 0st),0.058,
WH Moule (AUS),1880-1880,1,2,1,1,0,0,1,1 (1ct 0st),0.500,
Mufasir-ul-Haq (PAK),1965-1965,1,2,1,1,0,0,1,1 (1ct 0st),0.500,
Munir Malik (PAK),1959-1962,3,4,1,1,0,0,1,1 (1ct 0st),0.250,
Mustafizur Rahman (BAN),2015-2022,15,25,1,1,0,0,1,1 (1ct 0st),0.040,
CT Mutombodzi (ZIM),2020-2020,1,2,1,1,0,0,1,1 (1ct 0st),0.500,
S Nadeem (IND),2019-2021,2,4,1,1,0,0,1,1 (1ct 0st),0.250,
Nasir Jamshed (PAK),2013-2013,2,4,1,1,0,0,1,1 (1ct 0st),0.250,
JG Navle (IND),1932-1933,2,4,1,1,0,1,0,1 (1ct 0st),0.250,
SV Nayak (IND),1982-1982,2,3,1,1,0,0,1,1 (1ct 0st),0.333,
Nazimuddin (BAN),2011-2012,3,5,1,1,0,0,1,1 (1ct 0st),0.200,
N Ncube (ZIM),2011-2011,1,2,1,1,0,0,1,1 (1ct 0st),0.500,
JD Nel (SA),1949-1957,6,10,1,1,0,0,1,1 (1ct 0st),0.100,
PJ Newport (ENG),1988-1991,3,6,1,1,0,0,1,1 (1ct 0st),0.166,
M Ngam (SA),2000-2001,3,5,1,1,0,0,1,1 (1ct 0st),0.200,
R Ngarava (ZIM),2021-2023,4,6,1,1,0,0,1,1 (1ct 0st),0.166,
Niaz Ahmed (PAK),1967-1969,2,4,1,1,0,0,1,1 (1ct 0st),0.250,
G Noblet (AUS),1950-1953,3,6,1,1,0,0,1,1 (1ct 0st),0.166,
Noman Ali (PAK),2021-2023,15,29,1,1,0,0,1,1 (1ct 0st),0.034,
AL Ochse (SA),1928-1929,3,6,1,1,0,0,1,1 (1ct 0st),0.166,
JL Ontong (SA),2002-2004,2,4,1,1,0,0,1,1 (1ct 0st),0.250,
GWF Overton (NZ),1953-1954,3,5,1,1,0,0,1,1 (1ct 0st),0.200,
AW Palm (SA),1927-1928,1,2,1,1,0,0,1,1 (1ct 0st),0.500,
BA Parchment (WI),2008-2008,2,3,1,1,0,0,1,1 (1ct 0st),0.333,
GAHM Parkar (IND),1982-1982,1,2,1,1,0,0,1,1 (1ct 0st),0.500,
DC Parkin (SA),1892-1892,1,1,1,1,0,0,1,1 (1ct 0st),1.000,
NT Pascal (WI),2010-2010,2,2,1,1,0,0,1,1 (1ct 0st),0.500,
RGM Patel (IND),1988-1988,1,2,1,1,0,0,1,1 (1ct 0st),0.500,
D Paterson (SA),2020-2020,2,3,1,1,0,0,1,1 (1ct 0st),0.333,
SR Patil (IND),1955-1955,1,2,1,1,0,0,1,1 (1ct 0st),0.500,
SG Peall (ZIM),1993-1994,4,7,1,1,0,0,1,1 (1ct 0st),0.142,
COC Pearse (SA),1910-1911,3,5,1,1,0,0,1,1 (1ct 0st),0.200,
ASA Perera (SL),1998-2001,3,6,1,1,0,0,1,1 (1ct 0st),0.166,
NLTC Perera (SL),2011-2012,6,9,1,1,0,0,1,1 (1ct 0st),0.111,
RTD Perks (ENG),1939-1939,2,3,1,1,0,0,1,1 (1ct 0st),0.333,
NO Perry (WI),1999-1999,4,7,1,1,0,0,1,1 (1ct 0st),0.142,
GD Phillips (NZ),2020-2020,1,2,1,1,0,0,1,1 (1ct 0st),0.500,
OJ Phillips (WI),2009-2009,2,4,1,1,0,0,1,1 (1ct 0st),0.250,
CJ Poole (ENG),1951-1952,3,5,1,1,0,0,1,1 (1ct 0st),0.200,
MB Poore (NZ),1953-1956,14,20,1,1,0,0,1,1 (1ct 0st),0.050,
RL Powell (WI),1999-2004,2,4,1,1,0,0,1,1 (1ct 0st),0.250,
N Puna (NZ),1966-1966,3,5,1,1,0,0,1,1 (1ct 0st),0.200,
NA Quinn (SA),1929-1932,12,19,1,1,0,0,1,1 (1ct 0st),0.052,
LS Rajput (IND),1985-1985,2,4,1,1,0,0,1,1 (1ct 0st),0.250,
L Ramji (IND),1933-1933,1,2,1,1,0,0,1,1 (1ct 0st),0.500,
KM Rangnekar (IND),1947-1948,3,4,1,1,0,0,1,1 (1ct 0st),0.250,
VB Ranjane (IND),1958-1964,7,14,1,1,0,0,1,1 (1ct 0st),0.071,
Ranjan Das (BAN),2000-2000,1,2,1,1,0,0,1,1 (1ct 0st),0.500,
JR Ratnayeke (SL),1982-1989,22,32,1,1,0,0,1,1 (1ct 0st),0.031,
JC Reedman (AUS),1894-1894,1,2,1,1,0,0,1,1 (1ct 0st),0.500,
DA Reeve (ENG),1992-1992,3,6,1,1,0,0,1,1 (1ct 0st),0.166,
MR Rege (IND),1949-1949,1,1,1,1,0,0,1,1 (1ct 0st),1.000,
SF Rehman (PAK),1958-1958,1,2,1,1,0,0,1,1 (1ct 0st),0.500,
JA Rennie (ZIM),1993-1997,4,8,1,1,0,0,1,1 (1ct 0st),0.125,
AJ Richardson (AUS),1924-1926,9,14,1,1,0,0,1,1 (1ct 0st),0.071,
DW Richardson (ENG),1957-1957,1,2,1,1,0,0,1,1 (1ct 0st),0.500,
RD Rickelton (SA),2022-2023,4,8,1,1,0,0,1,1 (1ct 0st),0.125,
GR Robertson (AUS),1998-1998,4,7,1,1,0,0,1,1 (1ct 0st),0.142,
RH Robinson (AUS),1936-1936,1,2,1,1,0,0,1,1 (1ct 0st),0.500,
BG Rogers (ZIM),2005-2005,4,6,1,1,0,0,1,1 (1ct 0st),0.166,
CF Root (ENG),1926-1926,3,3,1,1,0,0,1,1 (1ct 0st),0.333,
GF Rorke (AUS),1959-1959,4,8,1,1,0,0,1,1 (1ct 0st),0.125,
CG Rowe (NZ),1946-1946,1,1,1,1,0,0,1,1 (1ct 0st),1.000,
JJ Roy (ENG),2019-2019,5,10,1,1,0,0,1,1 (1ct 0st),0.100,
P Roy (IND),1982-1982,2,2,1,1,0,0,1,1 (1ct 0st),0.500,
AD Russell (WI),2010-2010,1,2,1,1,0,0,1,1 (1ct 0st),0.500,
MJ Saggers (ENG),2003-2004,3,6,1,1,0,0,1,1 (1ct 0st),0.166,
NA Saini (IND),2021-2021,2,4,1,1,0,0,1,1 (1ct 0st),0.250,
SV Samuelson (SA),1910-1910,1,2,1,1,0,0,1,1 (1ct 0st),0.500,
BS Sandhu (IND),1983-1983,8,11,1,1,0,0,1,1 (1ct 0st),0.090,
Sanuar Hossain (BAN),2001-2003,9,11,1,1,0,0,1,1 (1ct 0st),0.090,
Sarandeep Singh (IND),2000-2002,3,5,1,1,0,0,1,1 (1ct 0st),0.200,
CJ Sayers (AUS),2018-2018,1,2,1,1,0,0,1,1 (1ct 0st),0.500,
AW Seccull (SA),1896-1896,1,1,1,1,0,0,1,1 (1ct 0st),1.000,
J Selby (ENG),1877-1882,6,11,1,1,0,1,0,1 (1ct 0st),0.090,
RHD Sellers (AUS),1964-1964,1,1,1,1,0,0,1,1 (1ct 0st),1.000,
MWW Selvey (ENG),1976-1977,3,6,1,1,0,0,1,1 (1ct 0st),0.166,
SMSM Senanayake (SL),2013-2014,1,2,1,1,0,0,1,1 (1ct 0st),0.500,
D Shackleton (ENG),1950-1963,7,13,1,1,0,0,1,1 (1ct 0st),0.076,
Shahriar Hossain (BAN),2000-2004,3,5,1,0,1,0,0,1 (0ct 1st),0.200,
Shakeel Ahmed snr (PAK),1998-1998,1,2,1,1,0,0,1,1 (1ct 0st),0.500,
AK Sharma (IND),1988-1988,1,2,1,1,0,0,1,1 (1ct 0st),0.500,
PH Sharma (IND),1974-1977,5,7,1,1,0,0,1,1 (1ct 0st),0.142,
SK Sharma (IND),1988-1990,2,4,1,1,0,0,1,1 (1ct 0st),0.250,
J Sharp (ENG),1909-1909,3,6,1,1,0,0,1,1 (1ct 0st),0.166,
IT Shillingford (WI),1977-1978,4,8,1,1,0,0,1,1 (1ct 0st),0.125,
RH Shodhan (IND),1952-1953,3,6,1,1,0,0,1,1 (1ct 0st),0.166,
M Shumba (ZIM),2021-2023,4,5,1,1,0,0,1,1 (1ct 0st),0.200,
K Shuttleworth (ENG),1970-1971,5,9,1,1,0,0,1,1 (1ct 0st),0.111,
IR Siddiqui (IND),2001-2001,1,2,1,1,0,0,1,1 (1ct 0st),0.500,
KJ Silva (SL),1995-1998,7,12,1,1,0,0,1,1 (1ct 0st),0.083,
GHT Simpson-Hayward (ENG),1910-1910,5,10,1,1,0,0,1,1 (1ct 0st),0.100,
IM Sinclair (NZ),1956-1956,2,3,1,1,0,0,1,1 (1ct 0st),0.333,
R Singh (IND),1999-1999,1,2,1,1,0,0,1,1 (1ct 0st),0.500,
VRV Singh (IND),2006-2007,5,10,1,1,0,0,1,1 (1ct 0st),0.100,
CIJ Smith (ENG),1935-1937,5,9,1,1,0,0,1,1 (1ct 0st),0.111,
D Smith (ENG),1935-1935,2,4,1,1,0,0,1,1 (1ct 0st),0.250,
FB Smith (NZ),1947-1952,4,7,1,1,0,0,1,1 (1ct 0st),0.142,
H Smith (ENG),1928-1928,1,2,1,1,0,1,0,1 (1ct 0st),0.500,
SB Smith (AUS),1984-1984,3,6,1,1,0,0,1,1 (1ct 0st),0.166,
TPB Smith (ENG),1946-1947,4,5,1,1,0,0,1,1 (1ct 0st),0.200,
RP Snell (SA),1992-1994,5,9,1,1,0,0,1,1 (1ct 0st),0.111,
WRT Solomon (SA),1899-1899,1,2,1,1,0,0,1,1 (1ct 0st),0.500,
WH St Hill (WI),1928-1930,3,4,1,1,0,0,1,1 (1ct 0st),0.250,
DA Stirling (NZ),1984-1986,6,11,1,1,0,0,1,1 (1ct 0st),0.090,
OP Stone (ENG),2019-2021,3,6,1,1,0,0,1,1 (1ct 0st),0.166,
MD Stoneman (ENG),2017-2018,11,19,1,1,0,0,1,1 (1ct 0st),0.052,
GB Street (ENG),1923-1923,1,1,1,0,1,0,0,1 (0ct 1st),1.000,
PC Strydom (SA),2000-2000,2,4,1,1,0,0,1,1 (1ct 0st),0.250,
MJ Susskind (SA),1924-1924,5,5,1,1,0,0,1,1 (1ct 0st),0.200,
SW Tait (AUS),2005-2008,3,6,1,1,0,0,1,1 (1ct 0st),0.166,
Talha Jubair (BAN),2002-2004,7,9,1,1,0,0,1,1 (1ct 0st),0.111,
Tanvir Ahmed (PAK),2010-2013,5,10,1,1,0,0,1,1 (1ct 0st),0.100,
GL Tapscott (SA),1913-1913,1,1,1,1,0,0,1,1 (1ct 0st),1.000,
Tareq Aziz (BAN),2004-2004,3,4,1,1,0,0,1,1 (1ct 0st),0.250,
K Taylor (ENG),1959-1964,3,6,1,1,0,0,1,1 (1ct 0st),0.166,
LB Taylor (ENG),1985-1985,2,4,1,1,0,0,1,1 (1ct 0st),0.250,
HT Tector (IRE),2023-2023,4,6,1,1,0,0,1,1 (1ct 0st),0.166,
M Theekshana (SL),2022-2022,2,4,1,1,0,0,1,1 (1ct 0st),0.250,
DC Thomas (WI),2022-2022,1,2,1,1,0,0,1,1 (1ct 0st),0.500,
G Thornton (SA),1902-1902,1,2,1,1,0,0,1,1 (1ct 0st),0.500,
BM Tickner (NZ),2023-2023,3,6,1,1,0,0,1,1 (1ct 0st),0.166,
JC Tongue (ENG),2023-2023,2,4,1,1,0,0,1,1 (1ct 0st),0.250,
DCH Townsend (ENG),1935-1935,3,5,1,1,0,0,1,1 (1ct 0st),0.200,
JPF Travers (AUS),1902-1902,1,2,1,1,0,0,1,1 (1ct 0st),0.500,
PB Truscott (NZ),1965-1965,1,2,1,1,0,0,1,1 (1ct 0st),0.500,
LL Tsotsobe (SA),2010-2011,5,9,1,1,0,0,1,1 (1ct 0st),0.111,
NC Tufnell (ENG),1910-1910,1,2,1,0,1,0,0,1 (0ct 1st),0.500,
MJL Turnbull (ENG),1930-1936,9,17,1,1,0,0,1,1 (1ct 0st),0.058,
Tushar Imran (BAN),2002-2007,5,6,1,1,0,0,1,1 (1ct 0st),0.166,
RK Tyldesley (ENG),1924-1930,7,11,1,1,0,0,1,1 (1ct 0st),0.090,
SD Udal (ENG),2005-2006,4,7,1,1,0,0,1,1 (1ct 0st),0.142,
Umar Amin (PAK),2010-2010,4,8,1,1,0,0,1,1 (1ct 0st),0.125,
PGV van der Bijl (SA),1938-1939,5,8,1,1,0,0,1,1 (1ct 0st),0.125,
JDF Vandersay (SL),2022-2022,1,2,1,1,0,0,1,1 (1ct 0st),0.500,
M Venkataramana (IND),1989-1989,1,2,1,1,0,0,1,1 (1ct 0st),0.500,
DP Viljoen (ZIM),1998-2000,2,3,1,1,0,0,1,1 (1ct 0st),0.333,
CH Vintcent (SA),1889-1892,3,4,1,1,0,0,1,1 (1ct 0st),0.250,
Vizianagram (IND),1936-1936,3,5,1,1,0,0,1,1 (1ct 0st),0.200,
A Waddington (ENG),1920-1921,2,4,1,1,0,0,1,1 (1ct 0st),0.250,
MG Waite (AUS),1938-1938,2,3,1,1,0,0,1,1 (1ct 0st),0.333,
AC Waller (ZIM),1996-1996,2,4,1,1,0,0,1,1 (1ct 0st),0.250,
A Ward (ENG),1893-1895,7,13,1,1,0,0,1,1 (1ct 0st),0.076,
FA Ward (AUS),1936-1938,4,6,1,1,0,0,1,1 (1ct 0st),0.166,
IJ Ward (ENG),2001-2001,5,9,1,1,0,0,1,1 (1ct 0st),0.111,
A Warren (ENG),1905-1905,1,2,1,1,0,0,1,1 (1ct 0st),0.500,
Washington Sundar (IND),2021-2021,4,8,1,1,0,0,1,1 (1ct 0st),0.125,
AS Wassan (IND),1990-1990,4,7,1,1,0,0,1,1 (1ct 0st),0.142,
SL Watkin (ENG),1991-1993,3,6,1,1,0,0,1,1 (1ct 0st),0.166,
JR Watkins (AUS),1973-1973,1,2,1,1,0,0,1,1 (1ct 0st),0.500,
M Watkinson (ENG),1995-1996,4,7,1,1,0,0,1,1 (1ct 0st),0.142,
CD Watson (WI),1960-1962,7,14,1,1,0,0,1,1 (1ct 0st),0.071,
GD Watson (AUS),1966-1972,5,9,1,1,0,0,1,1 (1ct 0st),0.111,
S Wazir Ali (IND),1932-1936,7,13,1,1,0,0,1,1 (1ct 0st),0.076,
C Wesley (SA),1960-1960,3,5,1,1,0,0,1,1 (1ct 0st),0.200,
T Westley (ENG),2017-2017,5,10,1,1,0,0,1,1 (1ct 0st),0.100,
JJ Whitaker (ENG),1986-1986,1,2,1,1,0,0,1,1 (1ct 0st),0.500,
AW White (WI),1965-1965,2,3,1,1,0,0,1,1 (1ct 0st),0.333,
CL White (AUS),2008-2008,4,8,1,1,0,0,1,1 (1ct 0st),0.125,
RGCE Wijesuriya (SL),1982-1985,4,6,1,1,0,0,1,1 (1ct 0st),0.166,
D Wilson (ENG),1964-1971,6,12,1,1,0,0,1,1 (1ct 0st),0.083,
PL Winslow (SA),1950-1955,5,8,1,1,0,0,1,1 (1ct 0st),0.125,
AJ Woodcock (AUS),1974-1974,1,2,1,1,0,0,1,1 (1ct 0st),0.500,
T Yohannan (IND),2001-2002,3,6,1,1,0,0,1,1 (1ct 0st),0.166,
HI Young (ENG),1899-1899,2,4,1,1,0,0,1,1 (1ct 0st),0.250,
Zahoor Elahi (PAK),1996-1996,2,4,1,1,0,0,1,1 (1ct 0st),0.250,
Zakir Khan (PAK),1986-1989,2,4,1,1,0,0,1,1 (1ct 0st),0.250,
M Zondeki (SA),2003-2008,6,11,1,1,0,0,1,1 (1ct 0st),0.090,
Abdul Wasi (AFG),2021-2021,1,2,0,0,0,0,0,0,0.000,
Abdur Rauf (PAK),2009-2009,3,6,0,0,0,0,0,0,0.000,
CA Absolom (ENG),1879-1879,1,2,0,0,0,0,0,0,0.000,
Aftab Baloch (PAK),1969-1975,2,4,0,0,0,0,0,0,0.000,
U Afzaal (ENG),2001-2001,3,4,0,0,0,0,0,0,0.000,
AC Agar (AUS),2013-2023,5,10,0,0,0,0,0,0,0.000,
Agha Zahid (PAK),1975-1975,1,2,0,0,0,0,0,0,0.000,
JP Agnew (ENG),1984-1985,3,6,0,0,0,0,0,0,0.000,
Rehan Ahmed (ENG),2022-2022,1,2,0,0,0,0,0,0,0.000,
Alamgir Kabir (BAN),2002-2004,3,4,0,0,0,0,0,0,0.000,
HH Alexander (AUS),1933-1933,1,2,0,0,0,0,0,0,0.000,
Imtiaz Ali (WI),1976-1976,1,2,0,0,0,0,0,0,0.000,
Kabir Ali (ENG),2003-2003,1,2,0,0,0,0,0,0,0.000,
Ali Hussain Rizvi (PAK),1997-1997,1,1,0,0,0,0,0,0,0.000,
FE Allan (AUS),1879-1879,1,2,0,0,0,0,0,0,0.000,
PJ Allan (AUS),1965-1965,1,2,0,0,0,0,0,0,0.000,
MJC Allom (ENG),1930-1931,5,8,0,0,0,0,0,0,0.000,
Al-Amin Hossain (BAN),2013-2019,7,11,0,0,0,0,0,0,0.000,
MKDI Amerasinghe (SL),2008-2008,1,2,0,0,0,0,0,0,0.000,
Amir Elahi (IND/PAK),1947-1952,6,9,0,0,0,0,0,0,0.000,
SA Ankola (IND),1989-1989,1,2,0,0,0,0,0,0,0.000,
Anwar Hossain Monir (BAN),2003-2005,3,3,0,0,0,0,0,0,0.000,
Anwar Hossain (BAN),2002-2002,1,1,0,0,0,0,0,0,0.000,
Anwar Hussain (PAK),1952-1952,4,6,0,0,0,0,0,0,0.000,
Anwar Khan (PAK),1979-1979,1,2,0,0,0,0,0,0,0.000,
AL Apte (IND),1959-1959,1,1,0,0,0,0,0,0,0.000,
AG Archer (ENG),1899-1899,1,2,0,0,0,0,0,0,0.000,
KA Archer (AUS),1950-1951,5,10,0,0,0,0,0,0,0.000,
Arif Butt (PAK),1964-1965,3,6,0,0,0,0,0,0,0.000,
T Armitage (ENG),1877-1877,2,4,0,0,0,0,0,0,0.000,
J Arnold (ENG),1931-1931,1,2,0,0,0,0,0,0,0.000,
Arshad Khan (PAK),1997-2005,9,17,0,0,0,0,0,0,0.000,
NS Asgarali (WI),1957-1957,2,2,0,0,0,0,0,0,0.000,
Ashfaq Ahmed (PAK),1993-1993,1,2,0,0,0,0,0,0,0.000,
WH Ashley (SA),1889-1889,1,1,0,0,0,0,0,0,0.000,
Atif Rauf (PAK),1994-1994,1,2,0,0,0,0,0,0,0.000,
Azam Khan (PAK),1996-1996,1,2,0,0,0,0,0,0,0.000,
Azhar Khan (PAK),1980-1980,1,2,0,0,0,0,0,0,0.000,
Azmat Rana (PAK),1980-1980,1,2,0,0,0,0,0,0,0.000,
Bahir Shah (AFG),2023-2023,1,2,0,0,0,0,0,0,0.000,
RJ Bailey (ENG),1988-1990,4,7,0,0,0,0,0,0,0.000,
MRCN Bandaratilleke (SL),1998-2001,7,14,0,0,0,0,0,0,0.000,
SN Banerjee (IND),1949-1949,1,2,0,0,0,0,0,0,0.000,
ST Banerjee (IND),1992-1992,1,2,0,0,0,0,0,0,0.000,
C Bannerman (AUS),1877-1879,3,6,0,0,0,0,0,0,0.000,
M Baqa Jilani (IND),1936-1936,1,2,0,0,0,0,0,0,0.000,
GD Barlow (ENG),1976-1977,3,6,0,0,0,0,0,0,0.000,
AG Barrett (WI),1971-1975,6,10,0,0,0,0,0,0,0.000,
VA Barton (ENG),1892-1892,1,2,0,0,0,0,0,0,0.000,
GR Beard (AUS),1980-1980,3,4,0,0,0,0,0,0,0.000,
JEF Beck (NZ),1953-1956,8,14,0,0,0,0,0,0,0.000,
J Benaud (AUS),1972-1973,3,6,0,0,0,0,0,0,0.000,
JE Benjamin (ENG),1994-1994,1,2,0,0,0,0,0,0,0.000,
HK Bennett (NZ),2010-2010,1,2,0,0,0,0,0,0,0.000,
MR Benson (ENG),1986-1986,1,2,0,0,0,0,0,0,0.000,
DE Bernard (WI),2003-2009,3,6,0,0,0,0,0,0,0.000,
BJ Bess (WI),2010-2010,1,2,0,0,0,0,0,0,0.000,
N Betancourt (WI),1930-1930,1,2,0,0,0,0,0,0,0.000,
M Bhanuka (SL),2021-2021,1,2,0,0,0,0,0,0,0.000,
AR Bhat (IND),1983-1983,2,3,0,0,0,0,0,0,0.000,
Bilawal Bhatti (PAK),2013-2014,2,4,0,0,0,0,0,0,0.000,
GF Bissett (SA),1927-1928,4,8,0,0,0,0,0,0,0.000,
MI Black (WI),2000-2002,6,10,0,0,0,0,0,0,0.000,
ID Blackwell (ENG),2006-2006,1,2,0,0,0,0,0,0,0.000,
EG Bock (SA),1935-1935,1,2,0,0,0,0,0,0,0.000,
GE Bond (SA),1938-1938,1,2,0,0,0,0,0,0,0.000,
MW Booth (ENG),1913-1914,2,4,0,0,0,0,0,0,0.000,
T Bosch (SA),1992-1992,1,2,0,0,0,0,0,0,0.000,
WM Bradley (ENG),1899-1899,2,4,0,0,0,0,0,0,0.000,
CR Brathwaite (WI),2015-2016,3,4,0,0,0,0,0,0,0.000,
W Brearley (ENG),1905-1912,4,8,0,0,0,0,0,0,0.000,
GA Briant (ZIM),1993-1993,1,1,0,0,0,0,0,0,0.000,
NT Broom (NZ),2017-2017,2,4,0,0,0,0,0,0,0.000,
LS Brown (SA),1931-1932,2,3,0,0,0,0,0,0,0.000,
GK Bruk-Jackson (ZIM),1993-1993,2,4,0,0,0,0,0,0,0.000,
C Burke (NZ),1946-1946,1,1,0,0,0,0,0,0,0.000,
SF Burke (SA),1962-1965,2,4,0,0,0,0,0,0,0.000,
EJK Burn (AUS),1890-1890,2,4,0,0,0,0,0,0,0.000,
AR Butcher (ENG),1979-1979,1,2,0,0,0,0,0,0,0.000,
LS Butler (WI),1955-1955,1,1,0,0,0,0,0,0,0.000,
LA Butterfield (NZ),1946-1946,1,1,0,0,0,0,0,0,0.000,
ID Buys (SA),1922-1922,1,2,0,0,0,0,0,0,0.000,
ST Callaway (AUS),1892-1895,3,6,0,0,0,0,0,0,0.000,
FJ Cameron (WI),1948-1949,5,10,0,0,0,0,0,0,0.000,
JH Cameron (WI),1939-1939,2,4,0,0,0,0,0,0,0.000,
C Campher (IRE),2023-2023,4,6,0,0,0,0,0,0,0.000,
DB Carr (ENG),1951-1952,2,2,0,0,0,0,0,0,0.000,
DW Carr (ENG),1909-1909,1,2,0,0,0,0,0,0,0.000,
HWR Cartwright (AUS),2017-2017,2,4,0,0,0,0,0,0,0.000,
G Challenor (WI),1928-1928,3,3,0,0,0,0,0,0,0.000,
HS Chang (WI),1979-1979,1,2,0,0,0,0,0,0,0.000,
PC Charlton (AUS),1890-1890,2,4,0,0,0,0,0,0,0.000,
HRJ Charlwood (ENG),1877-1877,2,4,0,0,0,0,0,0,0.000,
TL Chatara (ZIM),2013-2018,9,17,0,0,0,0,0,0,0.000,
W Chatterton (ENG),1892-1892,1,2,0,0,0,0,0,0,0.000,
CJ Chibhabha (ZIM),2016-2023,5,7,0,0,0,0,0,0,0.000,
MT Chinouya (ZIM),2016-2016,2,3,0,0,0,0,0,0,0.000,
TL Chivanga (ZIM),2023-2023,1,1,0,0,0,0,0,0,0.000,
N Chopra (IND),2000-2000,1,1,0,0,0,0,0,0,0.000,
NR Chowdhury (IND),1949-1951,2,3,0,0,0,0,0,0,0.000,
S Christopherson (ENG),1884-1884,1,2,0,0,0,0,0,0,0.000,
GWA Chubb (SA),1951-1951,5,9,0,0,0,0,0,0,0.000,
EW Clark (ENG),1929-1934,8,15,0,0,0,0,0,0,0.000,
CB Clarke (WI),1939-1939,3,6,0,0,0,0,0,0,0.000,
DC Cleverley (NZ),1932-1946,2,2,0,0,0,0,0,0,0.000,
JAK Cochran (SA),1931-1931,1,2,0,0,0,0,0,0,0.000,
G Coetzee (SA),2023-2023,2,4,0,0,0,0,0,0,0.000,
A Coningham (AUS),1894-1895,1,2,0,0,0,0,0,0,0.000,
C Cook (ENG),1947-1947,1,2,0,0,0,0,0,0,0.000,
FJ Cook (SA),1896-1896,1,2,0,0,0,0,0,0,0.000,
SH Cook (AUS),1997-1997,2,4,0,0,0,0,0,0,0.000,
SJ Cook (SA),1992-1993,3,5,0,0,0,0,0,0,0.000,
GE Corling (AUS),1964-1964,5,8,0,0,0,0,0,0,0.000,
SS Cottrell (WI),2013-2014,2,2,0,0,0,0,0,0,0.000,
G Coulthard (AUS),1882-1882,1,2,0,0,0,0,0,0,0.000,
Hon.CJ Coventry (ENG),1889-1889,2,4,0,0,0,0,0,0,0.000,
A Coxon (ENG),1948-1948,1,2,0,0,0,0,0,0,0.000,
MS Crane (ENG),2018-2018,1,1,0,0,0,0,0,0,0.000,
GF Cresswell (NZ),1949-1951,3,4,0,0,0,0,0,0,0.000,
G Cripps (SA),1892-1892,1,1,0,0,0,0,0,0,0.000,
GJ Crocker (ZIM),1992-1992,3,5,0,0,0,0,0,0,0.000,
DJ Cullen (AUS),2006-2006,1,2,0,0,0,0,0,0,0.000,
TK Curran (ENG),2017-2018,2,3,0,0,0,0,0,0,0.000,
AC Dale (AUS),1998-1999,2,4,0,0,0,0,0,0,0.000,
JW D'Arcy (NZ),1958-1958,5,6,0,0,0,0,0,0,0.000,
EQ Davies (SA),1936-1939,5,6,0,0,0,0,0,0,0.000,
SP Davis (AUS),1986-1986,1,1,0,0,0,0,0,0,0.000,
AC Dawson (SA),2003-2003,2,4,0,0,0,0,0,0,0.000,
EW Dawson (ENG),1928-1930,5,8,0,0,0,0,0,0,0.000,
Z de Bruyn (SA),2004-2004,3,5,0,0,0,0,0,0,0.000,
RP de Groen (NZ),1993-1994,5,7,0,0,0,0,0,0,0.000,
AR Dell (AUS),1971-1974,2,4,0,0,0,0,0,0,0.000,
GRA de Silva (SL),1982-1982,4,8,0,0,0,0,0,0,0.000,
DT Dewdney (WI),1955-1958,9,16,0,0,0,0,0,0,0.000,
JG Dewes (ENG),1948-1950,5,8,0,0,0,0,0,0,0.000,
AE Dipper (ENG),1921-1921,1,2,0,0,0,0,0,0,0.000,
GH Dockrell (IRE),2019-2023,2,3,0,0,0,0,0,0,0.000,
RG Draper (SA),1950-1950,2,3,0,0,0,0,0,0,0.000,
JRF Duncan (AUS),1971-1971,1,2,0,0,0,0,0,0,0.000,
FJ Durston (ENG),1921-1921,1,2,0,0,0,0,0,0,0.000,
DV Dyer (SA),1947-1947,3,6,0,0,0,0,0,0,0.000,
KH Eastwood (AUS),1971-1971,1,2,0,0,0,0,0,0,0.000,
HI Ebeling (AUS),1934-1934,1,2,0,0,0,0,0,0,0.000,
RM Edwards (WI),1968-1969,5,9,0,0,0,0,0,0,0.000,
WJ Edwards (AUS),1974-1974,3,6,0,0,0,0,0,0,0.000,
Ehsanul Haque (BAN),2002-2002,1,1,0,0,0,0,0,0,0.000,
Ehsan Adil (PAK),2013-2015,3,5,0,0,0,0,0,0,0.000,
RWG Emery (NZ),1952-1952,2,3,0,0,0,0,0,0,0.000,
GM Emmett (ENG),1948-1948,1,2,0,0,0,0,0,0,0.000,
AJ Evans (ENG),1921-1921,1,2,0,0,0,0,0,0,0.000,
B Evans (ZIM),2023-2023,1,2,0,0,0,0,0,0,0.000,
Faisal Hossain (BAN),2004-2004,1,2,0,0,0,0,0,0,0.000,
Farhan Adil (PAK),2003-2003,1,2,0,0,0,0,0,0,0.000,
Farooq Hamid (PAK),1964-1964,1,2,0,0,0,0,0,0,0.000,
Farrukh Zaman (PAK),1976-1976,1,2,0,0,0,0,0,0,0.000,
JP Faulkner (AUS),2013-2013,1,2,0,0,0,0,0,0,0.000,
CJ Ferguson (AUS),2016-2016,1,1,0,0,0,0,0,0,0.000,
LH Ferguson (NZ),2019-2019,1,2,0,0,0,0,0,0,0.000,
MP Fernandes (WI),1928-1930,2,3,0,0,0,0,0,0,0.000,
ERNS Fernando (SL),1983-1984,5,8,0,0,0,0,0,0,0.000,
KADM Fernando (SL),2003-2003,2,4,0,0,0,0,0,0,0.000,
NR Ferreira (ZIM),2005-2005,1,1,0,0,0,0,0,0,0.000,
CE Finlason (SA),1889-1889,1,2,0,0,0,0,0,0,0.000,
FE Fisher (NZ),1953-1953,1,1,0,0,0,0,0,0,0.000,
JA Flavell (ENG),1961-1964,4,7,0,0,0,0,0,0,0.000,
LO Fleetwood-Smith (AUS),1935-1938,10,18,0,0,0,0,0,0,0.000,
CE Floquet (SA),1910-1910,1,2,0,0,0,0,0,0,0.000,
H Foley (NZ),1930-1930,1,2,0,0,0,0,0,0,0.000,
AJ Fothergill (ENG),1889-1889,2,4,0,0,0,0,0,0,0.000,
CN Frank (SA),1921-1921,3,6,0,0,0,0,0,0,0.000,
WHB Frank (SA),1896-1896,1,1,0,0,0,0,0,0,0.000,
MC Frederick (WI),1954-1954,1,2,0,0,0,0,0,0,0.000,
DL Freeman (NZ),1933-1933,2,2,0,0,0,0,0,0,0.000,
FAW Freer (AUS),1946-1946,1,2,0,0,0,0,0,0,0.000,
RL Fuller (WI),1935-1935,1,2,0,0,0,0,0,0,0.000,
HA Furlonge (WI),1955-1956,3,5,0,0,0,0,0,0,0.000,
HG Gaekwad (IND),1952-1952,1,1,0,0,0,0,0,0,0.000,
IS Gallage (SL),1999-1999,1,2,0,0,0,0,0,0,0.000,
N Gallichan (NZ),1937-1937,1,2,0,0,0,0,0,0,0.000,
PLS Gamage (SL),2017-2018,5,9,0,0,0,0,0,0,0.000,
D Ganesh (IND),1997-1997,4,7,0,0,0,0,0,0,0.000,
AG Ganteaume (WI),1948-1948,1,2,0,0,0,0,0,0,0.000,
SG Gedye (NZ),1964-1965,4,8,0,0,0,0,0,0,0.000,
PR George (AUS),2010-2010,1,2,0,0,0,0,0,0,0.000,
MEZ Ghazali (PAK),1954-1954,2,2,0,0,0,0,0,0,0.000,
Ghulam Abbas (PAK),1967-1967,1,2,0,0,0,0,0,0,0.000,
OD Gibson (WI),1995-1999,2,4,0,0,0,0,0,0,0.000,
ESH Giddins (ENG),1999-2000,4,7,0,0,0,0,0,0,0.000,
DR Gilbert (AUS),1985-1986,9,13,0,0,0,0,0,0,0.000,
SR Gillespie (NZ),1986-1986,1,1,0,0,0,0,0,0,0.000,
AHH Gilligan (ENG),1930-1930,4,6,0,0,0,0,0,0,0.000,
G Gladstone (WI),1930-1930,1,2,0,0,0,0,0,0,0.000,
GK Glover (SA),1896-1896,1,1,0,0,0,0,0,0,0.000,
DW Gregory (AUS),1877-1879,3,6,0,0,0,0,0,0,0.000,
IA Greig (ENG),1982-1982,2,4,0,0,0,0,0,0,0.000,
BAF Grieve (ENG),1889-1889,2,4,0,0,0,0,0,0,0.000,
GM Griffin (SA),1960-1960,2,3,0,0,0,0,0,0,0.000,
TU Groube (AUS),1880-1880,1,2,0,0,0,0,0,0,0.000,
CEJ Guest (AUS),1963-1963,1,2,0,0,0,0,0,0,0.000,
RPW Guneratne (SL),1983-1983,1,1,0,0,0,0,0,0,0.000,
BP Gupte (IND),1961-1965,3,5,0,0,0,0,0,0,0.000,
A Habib (ENG),1999-1999,2,4,0,0,0,0,0,0,0.000,
GG Hall (SA),1965-1965,1,2,0,0,0,0,0,0,0.000,
C Hallows (ENG),1921-1928,2,3,0,0,0,0,0,0,0.000,
GM Hamilton (ENG),1999-1999,1,1,0,0,0,0,0,0,0.000,
RHM Hands (SA),1914-1914,1,2,0,0,0,0,0,0,0.000,
MA Hanley (SA),1949-1949,1,2,0,0,0,0,0,0,0.000,
HTW Hardinge (ENG),1921-1921,1,2,0,0,0,0,0,0,0.000,
NS Harford (NZ),1955-1958,8,11,0,0,0,0,0,0,0.000,
Haris Rauf (PAK),2022-2022,1,2,0,0,0,0,0,0,0.000,
RM Harris (NZ),1959-1959,2,2,0,0,0,0,0,0,0.000,
GPD Hartigan (SA),1912-1914,5,6,0,0,0,0,0,0,0.000,
AEV Hartkopf (AUS),1925-1925,1,2,0,0,0,0,0,0,0.000,
MR Harvey (AUS),1947-1947,1,2,0,0,0,0,0,0,0.000,
RL Harvey (SA),1936-1936,2,2,0,0,0,0,0,0,0.000,
Harvinder Singh (IND),1998-2001,3,6,0,0,0,0,0,0,0.000,
GG Hearne (ENG),1892-1892,1,2,0,0,0,0,0,0,0.000,
BE Hendricks (SA),2020-2020,1,2,0,0,0,0,0,0,0.000,
D Hettiarachchi (SL),2001-2001,1,2,0,0,0,0,0,0,0.000,
CFW Hime (SA),1896-1896,1,2,0,0,0,0,0,0,0.000,
JR Hodges (AUS),1877-1877,2,4,0,0,0,0,0,0,0.000,
CK Holder (WI),2020-2020,1,1,0,0,0,0,0,0,0.000,
JL Hopwood (ENG),1934-1934,2,3,0,0,0,0,0,0,0.000,
AN Hornby (ENG),1879-1884,3,5,0,0,0,0,0,0,0.000,
AB Howard (WI),1972-1972,1,1,0,0,0,0,0,0,0.000,
H Howell (ENG),1920-1924,5,8,0,0,0,0,0,0,0.000,
Humayun Farhat (PAK),2001-2001,1,1,0,0,0,0,0,0,0.000,
GI Hume (IRE),2023-2023,3,5,0,0,0,0,0,0,0.000,
KC Ibrahim (IND),1948-1949,4,6,0,0,0,0,0,0,0.000,
J Iddon (ENG),1935-1935,5,9,0,0,0,0,0,0,0.000,
Iftikhar Anjum (PAK),2006-2006,1,2,0,0,0,0,0,0,0.000,
Ijaz Faqih (PAK),1980-1988,5,8,0,0,0,0,0,0,0.000,
MC Ilott (ENG),1993-1995,5,8,0,0,0,0,0,0,0.000,
Imran Khan (PAK),2014-2019,10,19,0,0,0,0,0,0,0.000,
PJ Ingram (NZ),2010-2010,2,4,0,0,0,0,0,0,0.000,
RD Jackman (ENG),1981-1982,4,7,0,0,0,0,0,0,0.000,
WG Jacks (ENG),2022-2022,2,4,0,0,0,0,0,0,0.000,
AS Jaggernauth (WI),2008-2008,1,2,0,0,0,0,0,0,0.000,
LP Jai (IND),1933-1933,1,2,0,0,0,0,0,0,0.000,
Jalal-ud-Din (PAK),1982-1985,6,9,0,0,0,0,0,0,0.000,
SP James (ENG),1998-1998,2,4,0,0,0,0,0,0,0.000,
JA Jameson (ENG),1971-1974,4,6,0,0,0,0,0,0,0.000,
Javed Akhtar (PAK),1962-1962,1,1,0,0,0,0,0,0,0.000,
HK Jayantilal (IND),1971-1971,1,2,0,0,0,0,0,0,0.000,
RSA Jayasekera (SL),1982-1982,1,1,0,0,0,0,0,0,0.000,
S Jeganathan (SL),1983-1983,2,3,0,0,0,0,0,0,0.000,
DJ Johnson (IND),1996-1996,2,4,0,0,0,0,0,0,0.000,
HHH Johnson (WI),1948-1950,3,6,0,0,0,0,0,0,0.000,
RL Johnson (ENG),2003-2003,3,6,0,0,0,0,0,0,0.000,
RA Jones (NZ),2003-2003,1,2,0,0,0,0,0,0,0.000,
LM Jongwe (ZIM),2021-2021,1,1,0,0,0,0,0,0,0.000,
LR Joslin (AUS),1968-1968,1,2,0,0,0,0,0,0,0.000,
T Kaitano (ZIM),2021-2021,1,2,0,0,0,0,0,0,0.000,
Kamrul Islam Rabbi (BAN),2016-2018,7,13,0,0,0,0,0,0,0.000,
TP Kamungozi (ZIM),2014-2014,1,2,0,0,0,0,0,0,0.000,
TE Kane (IRE),2018-2018,1,2,0,0,0,0,0,0,0.000,
HH Kanitkar (IND),1999-2000,2,3,0,0,0,0,0,0,0.000,
HS Kanitkar (IND),1974-1974,2,3,0,0,0,0,0,0,0.000,
Karim Janat (AFG),2023-2023,1,2,0,0,0,0,0,0,0.000,
WW Keeton (ENG),1934-1939,2,2,0,0,0,0,0,0,0.000,
GA Kempis (SA),1889-1889,1,2,0,0,0,0,0,0,0.000,
SC Kerrigan (ENG),2013-2013,1,2,0,0,0,0,0,0,0.000,
Khalid Hasan (PAK),1954-1954,1,1,0,0,0,0,0,0,0.000,
Khalid Wazir (PAK),1954-1954,2,2,0,0,0,0,0,0,0.000,
A Khan (ENG),2009-2009,1,2,0,0,0,0,0,0,0.000,
JH King (ENG),1909-1909,1,2,0,0,0,0,0,0,0.000,
SP Kinneir (ENG),1911-1911,1,2,0,0,0,0,0,0,0.000,
NA Knox (ENG),1907-1907,2,4,0,0,0,0,0,0,0.000,
SC Kuggeleijn (NZ),2023-2023,1,2,0,0,0,0,0,0,0.000,
CKB Kulasekara (SL),2011-2011,1,2,0,0,0,0,0,0,0.000,
UN Kulkarni (IND),1967-1968,4,8,0,0,0,0,0,0,0.000,
AK Kuruppuarachchi (SL),1986-1987,2,3,0,0,0,0,0,0,0.000,
A Kuruvilla (IND),1997-1997,10,15,0,0,0,0,0,0,0.000,
F Kuys (SA),1899-1899,1,2,0,0,0,0,0,0,0.000,
MN Lathwell (ENG),1993-1993,2,3,0,0,0,0,0,0,0.000,
DV Lawrence (ENG),1988-1992,5,10,0,0,0,0,0,0,0.000,
HW Lee (ENG),1931-1931,1,2,0,0,0,0,0,0,0.000,
JG Leggat (NZ),1952-1956,9,10,0,0,0,0,0,0,0.000,
FL le Roux (SA),1914-1914,1,2,0,0,0,0,0,0,0.000,
AR Lewis (ENG),1972-1973,9,17,0,0,0,0,0,0,0.000,
J Lewis (ENG),2006-2006,1,2,0,0,0,0,0,0,0.000,
PT Lewis (SA),1913-1913,1,1,0,0,0,0,0,0,0.000,
RN Lewis (WI),1997-2008,5,9,0,0,0,0,0,0,0.000,
GF Linde (SA),2019-2021,3,5,0,0,0,0,0,0,0.000,
LS Livingstone (ENG),2022-2022,1,2,0,0,0,0,0,0,0.000,
DK Liyanage (SL),1992-2001,9,15,0,0,0,0,0,0,0.000,
TA Lloyd (ENG),1984-1984,1,1,0,0,0,0,0,0,0.000,
ACI Lock (ZIM),1995-1995,1,2,0,0,0,0,0,0,0.000,
GR Loveridge (NZ),1996-1996,1,2,0,0,0,0,0,0,0.000,
EB Lundie (SA),1914-1914,1,2,0,0,0,0,0,0,0.000,
MJ Macaulay (SA),1965-1965,1,2,0,0,0,0,0,0,0.000,
AR McBrine (IRE),2019-2023,6,10,0,0,0,0,0,0,0.000,
JCW MacBryan (ENG),1924-1924,1,1,0,0,0,0,0,0,0.000,
BE McGain (AUS),2009-2009,1,1,0,0,0,0,0,0,0.000,
HM McGirr (NZ),1930-1930,2,3,0,0,0,0,0,0,0.000,
PE McIntyre (AUS),1995-1996,2,4,0,0,0,0,0,0,0.000,
AJ McKay (NZ),2010-2010,1,1,0,0,0,0,0,0,0.000,
FA MacKinnon (ENG),1879-1879,1,2,0,0,0,0,0,0,0.000,
JW McLaren (AUS),1912-1912,1,2,0,0,0,0,0,0,0.000,
R McLaren (SA),2010-2014,2,4,0,0,0,0,0,0,0.000,
EG McLeod (NZ),1930-1930,1,2,0,0,0,0,0,0,0.000,
JEP McMaster (ENG),1889-1889,1,2,0,0,0,0,0,0,0.000,
DAN McRae (NZ),1946-1946,1,1,0,0,0,0,0,0,0.000,
MAWR Madurasinghe (SL),1988-1992,3,5,0,0,0,0,0,0,0.000,
Mahbubul Alam (BAN),2008-2008,4,6,0,0,0,0,0,0,0.000,
SI Mahmood (ENG),2006-2007,8,14,0,0,0,0,0,0,0.000,
JWH Makepeace (ENG),1920-1921,4,7,0,0,0,0,0,0,0.000,
NA Mallender (ENG),1992-1992,2,4,0,0,0,0,0,0,0.000,
MF Malone (AUS),1977-1977,1,2,0,0,0,0,0,0,0.000,
LA Markham (SA),1949-1949,1,2,0,0,0,0,0,0,0.000,
VJ Marks (ENG),1982-1984,6,12,0,0,0,0,0,0,0.000,
AP Marr (AUS),1885-1885,1,2,0,0,0,0,0,0,0.000,
NE Marshall (WI),1955-1955,1,2,0,0,0,0,0,0,0.000,
BP Martin (NZ),2013-2013,5,9,0,0,0,0,0,0,0.000,
JW Martin (ENG),1947-1947,1,2,0,0,0,0,0,0,0.000,
WFE Marx (SA),1921-1921,3,6,0,0,0,0,0,0,0.000,
MJ Mason (NZ),2004-2004,1,2,0,0,0,0,0,0,0.000,
Masood Anwar (PAK),1990-1990,1,2,0,0,0,0,0,0,0.000,
EZ Matambanadzo (ZIM),1996-1999,3,6,0,0,0,0,0,0,0.000,
T Meale (NZ),1958-1958,2,3,0,0,0,0,0,0,0.000,
PHKD Mendis (SL),2022-2022,1,2,0,0,0,0,0,0,0.000,
JM Mennie (AUS),2016-2016,1,1,0,0,0,0,0,0,0.000,
KO Meth (ZIM),2013-2013,2,4,0,0,0,0,0,0,0.000,
EM Meuli (NZ),1953-1953,1,1,0,0,0,0,0,0,0.000,
AM Miller (ENG),1896-1896,1,2,0,0,0,0,0,0,0.000,
NO Miller (WI),2009-2009,1,2,0,0,0,0,0,0,0.000,
RC Miller (WI),1953-1953,1,2,0,0,0,0,0,0,0.000,
MJ Mindley (WI),2022-2022,1,2,0,0,0,0,0,0,0.000,
RB Minnett (AUS),1911-1912,9,16,0,0,0,0,0,0,0.000,
Miran Bakhsh (PAK),1955-1955,2,4,0,0,0,0,0,0,0.000,
SF Mire (ZIM),2017-2017,2,3,0,0,0,0,0,0,0.000,
Mir Hamza (PAK),2018-2023,3,6,0,0,0,0,0,0,0.000,
NS Mitchell-Innes (ENG),1935-1935,1,2,0,0,0,0,0,0,0.000,
A Mithun (IND),2010-2011,4,8,0,0,0,0,0,0,0.000,
Mohammad Aslam (PAK),1954-1954,1,1,0,0,0,0,0,0,0.000,
Mohammad Irfan (PAK),2013-2013,4,6,0,0,0,0,0,0,0.000,
Mohammad Khalil (PAK),2004-2005,2,4,0,0,0,0,0,0,0.000,
Mohammad Munaf (PAK),1959-1962,4,8,0,0,0,0,0,0,0.000,
Mohammad Shahid (BAN),2015-2015,5,6,0,0,0,0,0,0,0.000,
Mohammad Shahzad (AFG),2018-2019,2,3,0,0,0,0,0,0,0.000,
Mohammad Zahid (PAK),1996-2003,5,9,0,0,0,0,0,0,0.000,
DS Mohanty (IND),1997-1997,2,4,0,0,0,0,0,0,0.000,
JA Morkel (SA),2009-2009,1,2,0,0,0,0,0,0,0.000,
J Moroney (AUS),1949-1952,7,13,0,0,0,0,0,0,0.000,
S Morris (AUS),1885-1885,1,2,0,0,0,0,0,0,0.000,
JK Moss (AUS),1979-1979,1,2,0,0,0,0,0,0,0.000,
VM Muddiah (IND),1959-1960,2,3,0,0,0,0,0,0,0.000,
GH Mudie (WI),1935-1935,1,2,0,0,0,0,0,0,0.000,
BS Mudzinganyama (ZIM),2020-2020,1,2,0,0,0,0,0,0,0.000,
Muhammad Musa (PAK),2019-2019,1,1,0,0,0,0,0,0,0.000,
Mujeeb Ur Rahman (AFG),2018-2018,1,1,0,0,0,0,0,0,0.000,
Mukesh Kumar (IND),2023-2023,1,2,0,0,0,0,0,0,0.000,
Munir Ahmad (AFG),2021-2021,1,2,0,0,0,0,0,0,0.000,
C Munro (NZ),2013-2013,1,1,0,0,0,0,0,0,0.000,
TA Munton (ENG),1992-1992,2,4,0,0,0,0,0,0,0.000,
T Mupariwa (ZIM),2004-2004,1,1,0,0,0,0,0,0,0.000,
TJ Murtagh (IRE),2018-2019,3,6,0,0,0,0,0,0,0.000,
HA Musgrove (AUS),1885-1885,1,2,0,0,0,0,0,0,0.000,
DT Mutendera (ZIM),2000-2000,1,2,0,0,0,0,0,0,0.000,
F Mutizwa (ZIM),2012-2012,1,1,0,0,0,0,0,0,0.000,
B Muzarabani (ZIM),2017-2021,6,9,0,0,0,0,0,0,0.000,
W Mwayenga (ZIM),2005-2005,1,2,0,0,0,0,0,0,0.000,
Nadeem Ghauri (PAK),1990-1990,1,1,0,0,0,0,0,0,0.000,
Nadeem Khan (PAK),1993-1999,2,4,0,0,0,0,0,0,0.000,
LE Nagel (AUS),1932-1932,1,2,0,0,0,0,0,0,0.000,
SS Naik (IND),1974-1975,3,4,0,0,0,0,0,0,0.000,
Naoomal Jaoomal (IND),1932-1934,3,6,0,0,0,0,0,0,0.000,
T Natarajan (IND),2021-2021,1,2,0,0,0,0,0,0,0.000,
Naved Anjum (PAK),1989-1990,2,4,0,0,0,0,0,0,0.000,
Naved Ashraf (PAK),1998-2000,2,4,0,0,0,0,0,0,0.000,
Naved Latif (PAK),2002-2002,1,2,0,0,0,0,0,0,0.000,
MN Nawaz (SL),2002-2002,1,2,0,0,0,0,0,0,0.000,
S Nazir Ali (IND),1932-1934,2,4,0,0,0,0,0,0,0.000,
Nazmul Hossain (BAN),2004-2011,2,3,0,0,0,0,0,0,0.000,
Nazmul Islam (BAN),2018-2018,1,2,0,0,0,0,0,0,0.000,
JM Neblett (WI),1935-1935,1,2,0,0,0,0,0,0,0.000,
MG Neser (AUS),2021-2022,2,4,0,0,0,0,0,0,0.000,
W Newham (ENG),1888-1888,1,2,0,0,0,0,0,0,0.000,
J Newman (NZ),1932-1933,3,3,0,0,0,0,0,0,0.000,
MJ Nicholson (AUS),1998-1998,1,2,0,0,0,0,0,0,0.000,
JFW Nicolson (SA),1928-1928,3,6,0,0,0,0,0,0,0.000,
Nijat Masood (AFG),2023-2023,1,2,0,0,0,0,0,0,0.000,
RAP Nissanka (SL),2003-2003,4,7,0,0,0,0,0,0,0.000,
NO Norton (SA),1910-1910,1,2,0,0,0,0,0,0,0.000,
OE Nothling (AUS),1928-1928,1,2,0,0,0,0,0,0,0.000,
S Nyalchand (IND),1952-1952,1,1,0,0,0,0,0,0,0.000,
KJ O'Brien (IRE),2018-2019,3,6,0,0,0,0,0,0,0.000,
AE Ochse (SA),1889-1889,2,3,0,0,0,0,0,0,0.000,
SNJ O'Keefe (AUS),2014-2017,9,16,0,0,0,0,0,0,0.000,
N Oldfield (ENG),1939-1939,1,1,0,0,0,0,0,0,0.000,
AH Omarshah (ZIM),1992-1996,3,5,0,0,0,0,0,0,0.000,
G Onions (ENG),2009-2012,9,16,0,0,0,0,0,0,0.000,
J Ormond (ENG),2001-2001,2,3,0,0,0,0,0,0,0.000,
J Overton (ENG),2022-2022,1,2,0,0,0,0,0,0,0.000,
DEV Padgett (ENG),1960-1960,2,4,0,0,0,0,0,0,0.000,
AL Padmore (WI),1976-1976,2,4,0,0,0,0,0,0,0.000,
DJ Pagon (WI),2005-2005,2,4,0,0,0,0,0,0,0.000,
AM Pai (IND),1969-1969,1,2,0,0,0,0,0,0,0.000,
PE Palia (IND),1932-1936,2,4,0,0,0,0,0,0,0.000,
CH Palmer (ENG),1954-1954,1,2,0,0,0,0,0,0,0.000,
KE Palmer (ENG),1965-1965,1,2,0,0,0,0,0,0,0.000,
RL Park (AUS),1920-1921,1,2,0,0,0,0,0,0,0.000,
RD Parkar (IND),1972-1973,2,4,0,0,0,0,0,0,0.000,
CWL Parker (ENG),1921-1921,1,1,0,0,0,0,0,0,0.000,
GM Parker (SA),1924-1924,2,2,0,0,0,0,0,0,0.000,
PWG Parker (ENG),1981-1981,1,2,0,0,0,0,0,0,0.000,
MW Parkinson (ENG),2022-2022,1,2,0,0,0,0,0,0,0.000,
JH Parks (ENG),1937-1937,1,2,0,0,0,0,0,0,0.000,
DD Parsana (IND),1979-1979,2,4,0,0,0,0,0,0,0.000,
Nawab of Pataudi snr (ENG/IND),1932-1946,6,11,0,0,0,0,0,0,0.000,
DJ Pattinson (ENG),2008-2008,1,2,0,0,0,0,0,0,0.000,
F Penn (ENG),1880-1880,1,2,0,0,0,0,0,0,0.000,
KK Peters (WI),2014-2014,1,1,0,0,0,0,0,0,0.000,
A Phillip (WI),2022-2022,2,4,0,0,0,0,0,0,0.000,
WN Phillips (AUS),1992-1992,1,2,0,0,0,0,0,0,0.000,
LR Pierre (WI),1948-1948,1,2,0,0,0,0,0,0,0.000,
ACS Pigott (ENG),1984-1984,1,1,0,0,0,0,0,0,0.000,
W Place (ENG),1948-1948,3,6,0,0,0,0,0,0,0.000,
JB Plimsoll (SA),1947-1947,1,2,0,0,0,0,0,0,0.000,
GH Pope (ENG),1947-1947,1,2,0,0,0,0,0,0,0.000,
RJ Pope (AUS),1885-1885,1,2,0,0,0,0,0,0,0.000,
RR Powar (IND),2007-2007,2,4,0,0,0,0,0,0,0.000,
S Prasanna (SL),2011-2011,1,1,0,0,0,0,0,0,0.000,
D Pretorius (SA),2002-2003,4,8,0,0,0,0,0,0,0.000,
RM Prideaux (ENG),1968-1969,3,6,0,0,0,0,0,0,0.000,
MW Priest (NZ),1990-1998,3,5,0,0,0,0,0,0,0.000,
CFH Prince (SA),1899-1899,1,2,0,0,0,0,0,0,0.000,
MW Pringle (SA),1992-1995,4,7,0,0,0,0,0,0,0.000,
WJ Pucovski (AUS),2021-2021,1,2,0,0,0,0,0,0,0.000,
Qaiser Abbas (PAK),2000-2000,1,2,0,0,0,0,0,0,0.000,
Qais Ahmad (AFG),2019-2019,1,2,0,0,0,0,0,0,0.000,
NV Radford (ENG),1986-1988,3,6,0,0,0,0,0,0,0.000,
Rafiqul Islam (BAN),2002-2002,1,1,0,0,0,0,0,0,0.000,
S Ragoonath (WI),1999-1999,2,4,0,0,0,0,0,0,0.000,
K Rai Singh (IND),1948-1948,1,2,0,0,0,0,0,0,0.000,
Rajinder Pal (IND),1964-1964,1,2,0,0,0,0,0,0,0.000,
C Ramaswami (IND),1936-1936,2,3,0,0,0,0,0,0,0.000,
AN Ranasinghe (SL),1982-1982,2,4,0,0,0,0,0,0,0.000,
D Ranatunga (SL),1989-1989,2,4,0,0,0,0,0,0,0.000,
U Ranchod (ZIM),1993-1993,1,1,0,0,0,0,0,0,0.000,
CR Rangachari (IND),1948-1948,4,4,0,0,0,0,0,0,0.000,
WB Rankin (ENG/IRE),2014-2019,3,6,0,0,0,0,0,0,0.000,
Rashid Khan (AFG),2018-2021,5,9,0,0,0,0,0,0,0.000,
V Razdan (IND),1989-1989,2,2,0,0,0,0,0,0,0.000,
HD Read (ENG),1935-1935,1,2,0,0,0,0,0,0,0.000,
RE Redmond (NZ),1973-1973,1,2,0,0,0,0,0,0,0.000,
N Reid (SA),1921-1921,1,2,0,0,0,0,0,0,0.000,
HJ Rhodes (ENG),1959-1959,2,4,0,0,0,0,0,0,0.000,
Riaz Afridi (PAK),2004-2004,1,2,0,0,0,0,0,0,0.000,
AR Richards (SA),1896-1896,1,1,0,0,0,0,0,0,0.000,
WHM Richards (SA),1889-1889,1,1,0,0,0,0,0,0,0.000,
JA Richardson (AUS),2019-2021,3,6,0,0,0,0,0,0,0.000,
TL Richmond (ENG),1921-1921,1,2,0,0,0,0,0,0,0.000,
KR Rickards (WI),1948-1952,2,4,0,0,0,0,0,0,0.000,
AT Roberts (WI),1956-1956,1,2,0,0,0,0,0,0,0.000,
LA Roberts (WI),1999-1999,1,2,0,0,0,0,0,0,0.000,
GK Robertson (NZ),1986-1986,1,2,0,0,0,0,0,0,0.000,
WR Robertson (AUS),1885-1885,1,2,0,0,0,0,0,0,0.000,
TS Roland-Jones (ENG),2017-2017,4,8,0,0,0,0,0,0,0.000,
AK Roy (IND),1969-1969,4,8,0,0,0,0,0,0,0.000,
FE Rumsey (ENG),1964-1965,5,10,0,0,0,0,0,0,0.000,
MW Rushmere (SA),1992-1992,1,2,0,0,0,0,0,0,0.000,
JW Rutherford (AUS),1956-1956,1,2,0,0,0,0,0,0,0.000,
Saif Hassan (BAN),2020-2021,6,10,0,0,0,0,0,0,0.000,
Sajedul Islam (BAN),2008-2013,3,5,0,0,0,0,0,0,0.000,
RL Sanghvi (IND),2001-2001,1,2,0,0,0,0,0,0,0.000,
CT Sarwate (IND),1946-1951,9,13,0,0,0,0,0,0,0.000,
RC Saxena (IND),1967-1967,1,2,0,0,0,0,0,0,0.000,
Sayed Shirzad (AFG),2021-2021,1,2,0,0,0,0,0,0,0.000,
CP Schofield (ENG),2000-2000,2,4,0,0,0,0,0,0,0.000,
SS Schultz (ENG),1879-1879,1,2,0,0,0,0,0,0,0.000,
AHP Scott (WI),1953-1953,1,2,0,0,0,0,0,0,0.000,
OC Scott (WI),1928-1931,8,11,0,0,0,0,0,0,0.000,
RH Scott (NZ),1947-1947,1,1,0,0,0,0,0,0,0.000,
BJ Sealey (WI),1933-1933,1,1,0,0,0,0,0,0,0.000,
TAP Sekhar (IND),1983-1983,2,2,0,0,0,0,0,0,0.000,
AK Sengupta (IND),1959-1959,1,2,0,0,0,0,0,0,0.000,
DG Sewell (NZ),1997-1997,1,2,0,0,0,0,0,0,0.000,
Shafiq Ahmed (PAK),1974-1981,6,10,0,0,0,0,0,0,0.000,
Shahidullah (AFG),2021-2021,1,2,0,0,0,0,0,0,0.000,
Shahid Mahboob (PAK),1989-1989,1,1,0,0,0,0,0,0,0.000,
Shahid Mahmood (PAK),1962-1962,1,1,0,0,0,0,0,0,0.000,
Shahid Saeed (PAK),1989-1989,1,2,0,0,0,0,0,0,0.000,
T Shamsi (SA),2016-2018,2,4,0,0,0,0,0,0,0.000,
Sharjeel Khan (PAK),2017-2017,1,2,0,0,0,0,0,0,0.000,
KV Sharma (IND),2014-2014,1,2,0,0,0,0,0,0,0.000,
SG Shinde (IND),1946-1952,7,13,0,0,0,0,0,0,0.000,
RC Shukla (IND),1982-1982,1,2,0,0,0,0,0,0,0.000,
J Shuter (ENG),1888-1888,1,2,0,0,0,0,0,0,0.000,
A Sidebottom (ENG),1985-1985,1,1,0,0,0,0,0,0,0.000,
RA Sinfield (ENG),1938-1938,1,2,0,0,0,0,0,0,0.000,
KN Slater (AUS),1959-1959,1,2,0,0,0,0,0,0,0.000,
J Slight (AUS),1880-1880,1,2,0,0,0,0,0,0,0.000,
TF Smailes (ENG),1946-1946,1,2,0,0,0,0,0,0,0.000,
MA Small (WI),1984-1984,2,4,0,0,0,0,0,0,0.000,
AM Smith (ENG),1997-1997,1,1,0,0,0,0,0,0,0.000,
CA Smith (ENG),1889-1889,1,2,0,0,0,0,0,0,0.000,
DBM Smith (AUS),1912-1912,2,3,0,0,0,0,0,0,0.000,
DM Smith (ENG),1986-1986,2,4,0,0,0,0,0,0,0.000,
DV Smith (ENG),1957-1957,3,6,0,0,0,0,0,0,0.000,
HD Smith (NZ),1933-1933,1,1,0,0,0,0,0,0,0.000,
GA Smithson (ENG),1948-1948,2,4,0,0,0,0,0,0,0.000,
CA Snedden (NZ),1947-1947,1,1,0,0,0,0,0,0,0.000,
Sohrawordi Shuvo (BAN),2011-2011,1,2,0,0,0,0,0,0,0.000,
JL Solozano (WI),2021-2021,1,2,0,0,0,0,0,0,0.000,
WER Somerville (NZ),2018-2021,6,12,0,0,0,0,0,0,0.000,
MM Sood (IND),1960-1960,1,1,0,0,0,0,0,0,0.000,
TE Srinivasan (IND),1981-1981,1,2,0,0,0,0,0,0,0.000,
SJ Staples (ENG),1928-1928,3,6,0,0,0,0,0,0,0.000,
SC Stayers (WI),1962-1962,4,8,0,0,0,0,0,0,0.000,
JP Stephenson (ENG),1989-1989,1,2,0,0,0,0,0,0,0.000,
GB Stevenson (ENG),1980-1981,2,3,0,0,0,0,0,0,0.000,
PJR Steyn (SA),1995-1995,3,6,0,0,0,0,0,0,0.000,
EL St Hill (WI),1930-1930,2,4,0,0,0,0,0,0,0.000,
VH Stollmeyer (WI),1939-1939,1,2,0,0,0,0,0,0,0.000,
GA Stuurman (SA),2022-2022,2,3,0,0,0,0,0,0,0.000,
Subashis Roy (BAN),2017-2017,4,7,0,0,0,0,0,0,0.000,
FH Sugg (ENG),1888-1888,2,4,0,0,0,0,0,0,0.000,
GR Sunderam (IND),1955-1956,2,4,0,0,0,0,0,0,0.000,
Sunzamul Islam (BAN),2018-2018,1,1,0,0,0,0,0,0,0.000,
VN Swamy (IND),1955-1955,1,2,0,0,0,0,0,0,0.000,
Syed Rasel (BAN),2005-2007,6,8,0,0,0,0,0,0,0.000,
HM Taberer (SA),1902-1902,1,2,0,0,0,0,0,0,0.000,
Tabish Khan (PAK),2021-2021,1,2,0,0,0,0,0,0,0.000,
VM Tancred (SA),1899-1899,1,2,0,0,0,0,0,0,0.000,
LE Tapscott (SA),1923-1923,2,4,0,0,0,0,0,0,0.000,
KK Tarapore (IND),1948-1948,1,1,0,0,0,0,0,0,0.000,
AI Taylor (SA),1956-1956,1,2,0,0,0,0,0,0,0.000,
D Taylor (SA),1914-1914,2,4,0,0,0,0,0,0,0.000,
JO Taylor (WI),1958-1959,3,5,0,0,0,0,0,0,0.000,
JP Taylor (ENG),1993-1994,2,4,0,0,0,0,0,0,0.000,
NHCD Theunissen (SA),1889-1889,1,1,0,0,0,0,0,0,0.000,
JG Thomas (ENG),1986-1986,5,9,0,0,0,0,0,0,0.000,
PIC Thompson (WI),1996-1997,2,3,0,0,0,0,0,0,0.000,
SR Thompson (IRE),2018-2019,3,6,0,0,0,0,0,0,0.000,
GR Thoms (AUS),1952-1952,1,2,0,0,0,0,0,0,0.000,
AL Thomson (AUS),1970-1971,4,8,0,0,0,0,0,0,0.000,
K Thomson (NZ),1968-1968,2,4,0,0,0,0,0,0,0.000,
HM Thurlow (AUS),1932-1932,1,2,0,0,0,0,0,0,0.000,
DS Tomlinson (SA),1935-1935,1,1,0,0,0,0,0,0,0.000,
GC Tonge (WI),2009-2009,1,2,0,0,0,0,0,0,0.000,
CL Townsend (ENG),1899-1899,2,4,0,0,0,0,0,0,0.000,
MF Tremlett (ENG),1948-1948,3,6,0,0,0,0,0,0,0.000,
GE Tribe (AUS),1946-1947,3,6,0,0,0,0,0,0,0.000,
CK Tshuma (ZIM),2020-2020,1,1,0,0,0,0,0,0,0.000,
PS Twentyman-Jones (SA),1902-1902,1,2,0,0,0,0,0,0,0.000,
EJ Tyler (ENG),1896-1896,1,2,0,0,0,0,0,0,0.000,
KEA Upashantha (SL),1999-2002,2,4,0,0,0,0,0,0,0.000,
Usman Salahuddin (PAK),2018-2018,1,1,0,0,0,0,0,0,0.000,
Usman Shinwari (PAK),2019-2019,1,1,0,0,0,0,0,0,0.000,
VA Valentine (WI),1933-1933,2,2,0,0,0,0,0,0,0.000,
RH Vance (NZ),1988-1989,4,4,0,0,0,0,0,0,0.000,
GD Varnals (SA),1964-1965,3,4,0,0,0,0,0,0,0.000,
GF Vernon (ENG),1882-1883,1,2,0,0,0,0,0,0,0.000,
GC Viljoen (SA),2016-2016,1,2,0,0,0,0,0,0,0.000,
R Vinay Kumar (IND),2012-2012,1,1,0,0,0,0,0,0,0.000,
J Vine (ENG),1912-1912,2,4,0,0,0,0,0,0,0.000,
Wafadar Momand (AFG),2018-2019,2,3,0,0,0,0,0,0,0.000,
LA Walcott (WI),1930-1930,1,2,0,0,0,0,0,0,0.000,
BGK Walker (NZ),2000-2002,5,8,0,0,0,0,0,0,0.000,
KP Walmsley (NZ),1995-2000,3,6,0,0,0,0,0,0,0.000,
Waqar Salamkheil (AFG),2019-2019,1,2,0,0,0,0,0,0,0.000,
KPJ Warnaweera (SL),1986-1994,10,15,0,0,0,0,0,0,0.000,
JJ Warr (ENG),1951-1951,2,3,0,0,0,0,0,0,0.000,
BT Watambwa (ZIM),2001-2002,6,11,0,0,0,0,0,0,0.000,
L Watt (NZ),1955-1955,1,2,0,0,0,0,0,0,0.000,
MG Webb (NZ),1971-1974,3,6,0,0,0,0,0,0,0.000,
KH Weekes (WI),1939-1939,2,4,0,0,0,0,0,0,0.000,
CDUS Weerasinghe (SL),1985-1985,1,2,0,0,0,0,0,0,0.000,
AP Wells (ENG),1995-1995,1,1,0,0,0,0,0,0,0.000,
RJ Westcott (SA),1954-1958,5,8,0,0,0,0,0,0,0.000,
A Wharton (ENG),1949-1949,1,2,0,0,0,0,0,0,0.000,
B White (IRE),2023-2023,3,4,0,0,0,0,0,0,0.000,
DJ White (NZ),1990-1990,2,3,0,0,0,0,0,0,0.000,
DW White (ENG),1961-1962,2,4,0,0,0,0,0,0,0.000,
PE Whitelaw (NZ),1933-1933,2,2,0,0,0,0,0,0,0.000,
CV Wight (WI),1928-1930,2,3,0,0,0,0,0,0,0.000,
GL Wight (WI),1953-1953,1,2,0,0,0,0,0,0,0.000,
KIW Wijegunawardene (SL),1991-1992,2,4,0,0,0,0,0,0,0.000,
G Wijekoon (SL),2005-2005,2,4,0,0,0,0,0,0,0.000,
PK Wijetunge (SL),1993-1993,1,2,0,0,0,0,0,0,0.000,
CA Wiles (WI),1933-1933,1,1,0,0,0,0,0,0,0.000,
LL Wilkinson (ENG),1938-1939,3,5,0,0,0,0,0,0,0.000,
ET Willett (WI),1973-1975,5,10,0,0,0,0,0,0,0.000,
NF Williams (ENG),1990-1990,1,1,0,0,0,0,0,0,0.000,
CM Willoughby (SA),2003-2003,2,4,0,0,0,0,0,0,0.000,
JT Willoughby (SA),1896-1896,2,3,0,0,0,0,0,0,0.000,
CEM Wilson (ENG),1899-1899,2,4,0,0,0,0,0,0,0.000,
ER Wilson (ENG),1921-1921,1,2,0,0,0,0,0,0,0.000,
JW Wilson (AUS),1956-1956,1,2,0,0,0,0,0,0,0.000,
P Wilson (AUS),1998-1998,1,1,0,0,0,0,0,0,0.000,
CS Wimble (SA),1892-1892,1,1,0,0,0,0,0,0,0.000,
KL Wishart (WI),1935-1935,1,2,0,0,0,0,0,0,0.000,
R Wood (ENG),1887-1887,1,2,0,0,0,0,0,0,0.000,
CW Wright (ENG),1896-1896,3,6,0,0,0,0,0,0,0.000,
EG Wynyard (ENG),1896-1906,3,6,0,0,0,0,0,0,0.000,
SA Yadav (IND),2023-2023,1,2,0,0,0,0,0,0,0.000,
Yamin Ahmadzai (AFG),2018-2023,6,11,0,0,0,0,0,0,0.000,
Yasir Ali (PAK),2003-2003,1,2,0,0,0,0,0,0,0.000,
Yasir Arafat (PAK),2007-2009,3,5,0,0,0,0,0,0,0.000,
B Yograj Singh (IND),1981-1981,1,2,0,0,0,0,0,0,0.000,
S Young (AUS),1997-1997,1,2,0,0,0,0,0,0,0.000,
Younis Ahmed (PAK),1969-1987,4,7,0,0,0,0,0,0,0.000,
Zafar Gohar (PAK),2021-2021,1,1,0,0,0,0,0,0,0.000,
Zahid Mahmood (PAK),2022-2022,2,4,0,0,0,0,0,0,0.000,
Zahir Khan (AFG),2019-2023,4,8,0,0,0,0,0,0,0.000,
Ziaur Rahman (BAN),2013-2013,1,2,0,0,0,0,0,0,0.000,
